TGCATGGCGTT -> GCATGGCGTTG
CCCGGAACAAA -> CCGGAACAAAT
CTGGAGAGGTA -> TGGAGAGGTAG
AGAAATTTATA -> GAAATTTATAC
AGGACCTACGG -> GGACCTACGGT
ATACACGAAAA -> TACACGAAAAC
ACGGGAACATA -> CGGGAACATAG
AGGTTGCTTTA -> GGTTGCTTTAC
CATCGCGAACC -> ATCGCGAACCA
TAGTTTTACGT -> AGTTTTACGTG
TGAAATCTTGG -> GAAATCTTGGA
TGCTCATCGCG -> GCTCATCGCGA
CCGAGCGCGGA -> CGAGCGCGGAC
GTATTTTGTTA -> TATTTTGTTAC
TTTCGCTAGCC -> TTCGCTAGCCC
CGAACTAGAGA -> GAACTAGAGAA
TCCTCCCCCAG -> CCTCCCCCAGG
ACTCATTTCCC -> CTCATTTCCCA
AGTCCGTAGAC -> GTCCGTAGACG
GGTGCTCCTGT -> GTGCTCCTGTC
ATCGGGCTGAG -> TCGGGCTGAGG
CCCCAGGGCCG -> CCCAGGGCCGA
TGTCAAGGTTC -> GTCAAGGTTCG
TGCGAATAAAT -> GCGAATAAATC
TCATCGACATT -> CATCGACATTG
GTATGTCAGTA -> TATGTCAGTAC
TCTGATTAGAT -> CTGATTAGATA
GCATCTATAAT -> CATCTATAATC
GCAGTCTTGGC -> CAGTCTTGGCA
GGACTTCTGCC -> GACTTCTGCCA
GATGGAACGTT -> ATGGAACGTTG
ATTCCCCGGAA -> TTCCCCGGAAC
ACGGGACGATT -> CGGGACGATTG
AACCGCGAGCT -> ACCGCGAGCTC
AACATAGATGG -> ACATAGATGGT
CCCAGTGTCCG -> CCAGTGTCCGG
AGAGTTGGTTT -> GAGTTGGTTTT
CTGTGACTCAG -> TGTGACTCAGG
GTGGATTGTGG -> TGGATTGTGGC
CGGTTTGCTAC -> GGTTTGCTACT
AGAACTCAACA -> GAACTCAACAG
AGGTGGCTACG -> GGTGGCTACGT
CTCTCCTGTTC -> TCTCCTGTTCG
TAGGATTAGGG -> AGGATTAGGGG
TATGTAATTCG -> ATGTAATTCGG
TTAGTAGGATT -> TAGTAGGATTA
TAAATCCGAGC -> AAATCCGAGCA
TGTAAATACGA -> GTAAATACGAA
AGTAGGCTCCT -> GTAGGCTCCTA
AGTACCCATGT -> GTACCCATGTT
GACTTCAATTA -> ACTTCAATTAC
GACTGTTCGGG -> ACTGTTCGGGT
TTTCAGGCCTG -> TTCAGGCCTGT
AGCCCCGCGAA -> GCCCCGCGAAT
CGGGACGATTG -> GGGACGATTGT
ATTGGAACTTA -> TTGGAACTTAG
GGAACACGGGG -> GAACACGGGGC
CGGCGGTTGTT -> GGCGGTTGTTA
CGTTTTAGTAG -> GTTTTAGTAGA
ATCCCGCGCAT -> TCCCGCGCATT
ACCGGGCCCTG -> CCGGGCCCTGA
AGTCCGGAGAC -> GTCCGGAGACG
ACCGCGAAGCA -> CCGCGAAGCAT
ATTATGGGCTC -> TTATGGGCTCC
TCTATAATCTT -> CTATAATCTTC
GGCGGTTGTTA -> GCGGTTGTTAG
TTCAGGGTATG -> TCAGGGTATGA
CCCATGTTAAC -> CCATGTTAACC
TAGTGCAACCA -> AGTGCAACCAT
TACTTGTCTAG -> ACTTGTCTAGT
GCTCGGGCTTG -> CTCGGGCTTGC
ATCCGCTCCCT -> TCCGCTCCCTG
TCTTGGCATTA -> CTTGGCATTAG
GTGCCGCGATC -> TGCCGCGATCG
AACGGGAACAT -> ACGGGAACATA
CGCGCGAACTG -> GCGCGAACTGG
CAAGGACCTAC -> AAGGACCTACG
CCCACAAGTAG -> CCACAAGTAGG
TGACACCAGTC -> GACACCAGTCA
AGTCTACTGGG -> GTCTACTGGGC
CATCCGCTCCC -> ATCCGCTCCCT
GGACGCCTTCA -> GACGCCTTCAG
TGATTAACACA -> GATTAACACAT
GGTTGCTTTAC -> GTTGCTTTACC
GTTTTATCCCA -> TTTTATCCCAC
CATAAGTGGAA -> ATAAGTGGAAA
TCATAAGTGGA -> CATAAGTGGAA
GTTGAAATCTT -> TTGAAATCTTG
CCCCCAGGAAC -> CCCCAGGAACA
CCTGTTCGTTA -> CTGTTCGTTAT
TGGCTACGTAC -> GGCTACGTACA
CCTCAGATGTG -> CTCAGATGTGG
ATAAGTATTTT -> TAAGTATTTTG
CGCGGACGCCT -> GCGGACGCCTT
AAATTTATACG -> AATTTATACGG
GGGACGATTGT -> GGACGATTGTT
GAGCGCGGACT -> AGCGCGGACTT
TGGGAGTCTCG -> GGGAGTCTCGT
TCTTTGTTGCC -> CTTTGTTGCCG
GAAAGTAGGCT -> AAAGTAGGCTC
CAGGCCTGTCT -> AGGCCTGTCTT
TGGAAAGTAGG -> GGAAAGTAGGC
GATAGAAATTT -> ATAGAAATTTA
GGATCGTACGT -> GATCGTACGTC
TTCGTTATATG -> TCGTTATATGA
GATGTGGATTG -> ATGTGGATTGA
TGCAACCCCAG -> GCAACCCCAGG
GCCCAATTGAC -> CCCAATTGACG
AAGAAGCTGCG -> AGAAGCTGCGA
TATGAGTATGT -> ATGAGTATGTC
TCAATGGCATC -> CAATGGCATCG
CAGTCATCCGC -> AGTCATCCGCT
GTATTCGAAGA -> TATTCGAAGAC
GTCATCCGCTC -> TCATCCGCTCC
GAATTTCTGCA -> AATTTCTGCAT
AAACGACCGCG -> AACGACCGCGG
ACATCCGACTT -> CATCCGACTTC
TTCTGCTCGAT -> TCTGCTCGATA
GCATGCGTTTA -> CATGCGTTTAG
ACGTTGCGAAT -> CGTTGCGAATA
GAGAGATGCGG -> AGAGATGCGGC
GTCTTTCCCTT -> TCTTTCCCTTC
GCGCGACAACC -> CGCGACAACCT
TGGTAGTGGAA -> GGTAGTGGAAA
GAAATCTTGGA -> AAATCTTGGAG
GAGAGGTAGCC -> AGAGGTAGCCC
TAATAAAAGGA -> AATAAAAGGAT
GTTGGTTTTTT -> TTGGTTTTTTC
CTCAACAGACG -> TCAACAGACGT
AACCTTGGCAA -> ACCTTGGCAAC
AGCACTGCCAG -> GCACTGCCAGT
CGTGTCTGCAG -> GTGTCTGCAGT
ATACGGGGCAT -> TACGGGGCATC
TCATCGCGAAC -> CATCGCGAACC
AAGTAGGTTGT -> AGTAGGTTGTT
CGCTCGGGCTT -> GCTCGGGCTTG
CTTTCACCTTT -> TTTCACCTTTC
TCATGTATTCG -> CATGTATTCGA
CATTGGTAAAG -> ATTGGTAAAGC
CATCTATAATC -> ATCTATAATCT
TCGTCGAGTCT -> CGTCGAGTCTA
ATTGTGGCATG -> TTGTGGCATGC
ATTGACTACAA -> TTGACTACAAG
TTAGTGCAACC -> TAGTGCAACCA
AGGTAGCCCTG -> GGTAGCCCTGT
GCAACTATTTA -> CAACTATTTAA
CTCGATAGGAT -> TCGATAGGATA
ACGATTCGTTG -> CGATTCGTTGG
AGTTCTCCAGC -> GTTCTCCAGCG
AATTACTTGGC -> ATTACTTGGCA
CGAAAGCCATA -> GAAAGCCATAC
CGAGTGTCCGT -> GAGTGTCCGTT
CATTTCCCACC -> ATTTCCCACCC
GTCAAGGTTCG -> TCAAGGTTCGA
GCAGTATAAAC -> CAGTATAAACC
CGGCCTTGATC -> GGCCTTGATCC
CTGCGCCGACA -> TGCGCCGACAT
CAACGATTCGT -> AACGATTCGTT
TAGAGAACGTT -> AGAGAACGTTG
CTTCAATTACC -> TTCAATTACCC
GTGAATTTCTG -> TGAATTTCTGC
GATTTCGTGAG -> ATTTCGTGAGA
AGGGTATGATT -> GGGTATGATTC
CCCTGTCTGAC -> CCTGTCTGACT
ATATCTGATTA -> TATCTGATTAG
GCGCCGACATG -> CGCCGACATGT
GGCTTTGGTCA -> GCTTTGGTCAG
TGTGGATTGAC -> GTGGATTGACT
CAATATGTAGA -> AATATGTAGAC
ACCATTGGTAA -> CCATTGGTAAA
GCGAAGCATCA -> CGAAGCATCAC
AGTGGAAAGTA -> GTGGAAAGTAG
AAGTAGGCTCC -> AGTAGGCTCCT
GCTCCCTAAAC -> CTCCCTAAACG
ATTTCGTGAGA -> TTTCGTGAGAG
TTCGGTTAACC -> TCGGTTAACCT
GTCACGCCGAG -> TCACGCCGAGC
CTGGCTTTGGT -> TGGCTTTGGTC
AACCTCAGATG -> ACCTCAGATGT
AATGGCATCGG -> ATGGCATCGGC
AGCGCTCGAGT -> GCGCTCGAGTG
AGATGCGGCCT -> GATGCGGCCTT
ACGTACACTAC -> CGTACACTACT
AGTAGGATTAG -> GTAGGATTAGG
AGTCTCGTAAC -> GTCTCGTAACA
TTTAACTGCGC -> TTAACTGCGCC
GTGATATAAGT -> TGATATAAGTA
TCTTTCACCTT -> CTTTCACCTTT
GCTCAGCGCTC -> CTCAGCGCTCG
GTGGATTGACT -> TGGATTGACTA
TCTTCGCAGTG -> CTTCGCAGTGC
CCGGGCCCTGA -> CGGGCCCTGAA
TGTCCGGATCG -> GTCCGGATCGT
AGATTCGGTCC -> GATTCGGTCCT
AAGTTGGCAGC -> AGTTGGCAGCA
GGCATGCGTTT -> GCATGCGTTTA
GGCTGCTCATC -> GCTGCTCATCG
GAAGCATCACA -> AAGCATCACAT
GGAACATAGAT -> GAACATAGATG
GCTAGCCCAAT -> CTAGCCCAATT
GAGCCATTATT -> AGCCATTATTA
TTGTGGCATGC -> TGTGGCATGCG
CTGAAGTTGGC -> TGAAGTTGGCA
CGCTTCCAGCA -> GCTTCCAGCAG
CGAATAAATCC -> GAATAAATCCG
CTGCCAGGTGC -> TGCCAGGTGCT
GAAATTTATAC -> AAATTTATACG
TAGCACATCCC -> AGCACATCCCG
GGCCTGTCTTC -> GCCTGTCTTCG
TCCGCTCCCTG -> CCGCTCCCTGT
CCCACTTTTTC -> CCACTTTTTCG
TATCCCACCCA -> ATCCCACCCAG
AACACCATTGG -> ACACCATTGGT
AATAACACCAT -> ATAACACCATT
ATTGACAAAGA -> TTGACAAAGAA
GGCTCCTCCGC -> GCTCCTCCGCC
TAACACCCGAA -> AACACCCGAAA
TCCGACTTCAA -> CCGACTTCAAT
TCGTATCTCAA -> CGTATCTCAAT
TTGGAGGAACA -> TGGAGGAACAC
TTGTTTTATCC -> TGTTTTATCCC
GAAGGTAAAGA -> AAGGTAAAGAA
TGGGAGTTTCA -> GGGAGTTTCAT
GAACAGTGCCG -> AACAGTGCCGC
GGACGATTGTT -> GACGATTGTTA
GGACCGAGCCA -> GACCGAGCCAT
TCAGCGCTCGA -> CAGCGCTCGAG
ACATCCCGCGC -> CATCCCGCGCA
AGATATGTAAC -> GATATGTAACA
CCCAGGAACAG -> CCAGGAACAGT
GGGCTCCTCCG -> GGCTCCTCCGC
CGTGAGAGCTC -> GTGAGAGCTCC
GAGTGAATTTC -> AGTGAATTTCT
ATCTTCAGTTT -> TCTTCAGTTTA
TTAACACATCG -> TAACACATCGG
ACGCTCAGCGC -> CGCTCAGCGCT
ACTCAACAGAC -> CTCAACAGACG
AGGATTAGGGG -> GGATTAGGGGC
GGAGTCTCGTA -> GAGTCTCGTAA
CTAGTGATTAG -> TAGTGATTAGT
GTCCGTAGACG -> TCCGTAGACGC
CGATCGTGATC -> GATCGTGATCA
AACCATATCCC -> ACCATATCCCT
CGATTGGAACT -> GATTGGAACTT
GTGGCATGCGT -> TGGCATGCGTT
ACTTGTGGGAG -> CTTGTGGGAGT
ACGTGGATGTT -> CGTGGATGTTT
CTGGGCGAGGA -> TGGGCGAGGAC
TACGGTTATTA -> ACGGTTATTAC
GTGACTCAGGT -> TGACTCAGGTG
GATTAGATACG -> ATTAGATACGT
TTAGTTTTCAG -> TAGTTTTCAGG
GGGTATGATTC -> GGTATGATTCT,GGTATGATTCT
TACCGAGTTCT -> ACCGAGTTCTC
CTCGATTGGAA -> TCGATTGGAAC
ACATTATGGGC -> CATTATGGGCT
GGTCCTCCCCC -> GTCCTCCCCCA
TTAGCCCCGCG -> TAGCCCCGCGA
GGCGCTTCCAG -> GCGCTTCCAGC
GCTCCTAGTTG -> CTCCTAGTTGA
GTTACTTGATT -> TTACTTGATTA
CAGTGTCCGGA -> AGTGTCCGGAT
ATACGAAGTAA -> TACGAAGTAAC
GTTTGTCTTAA -> TTTGTCTTAAC
CCGCGAGCTCT -> CGCGAGCTCTA
TTAACTGCGCC -> TAACTGCGCCG
AATAAAAGGAT -> ATAAAAGGATC
AATCTTGGAGG -> ATCTTGGAGGA
ATGTCCTGCAT -> TGTCCTGCATT
TCTCCAGCGGC -> CTCCAGCGGCG
CGGATCGTACG -> GGATCGTACGT
AGGTAAAGAAC -> GGTAAAGAACT
TATGATTCTTT -> ATGATTCTTTC
ATATGTAGACC -> TATGTAGACCG
GATTGTTACAA -> ATTGTTACAAT
GGATTGTGGCA -> GATTGTGGCAT
GCATCGGGCTG -> CATCGGGCTGA
GGAAAGTAGGC -> GAAAGTAGGCT
AGACACTGGGG -> GACACTGGGGA
ATTACTTGGCA -> TTACTTGGCAA
GGATTGACTAC -> GATTGACTACA
ATGCGTTTAGT -> TGCGTTTAGTT
GTGTCTGCAGT -> TGTCTGCAGTC
ACTGCGCCGAC -> CTGCGCCGACA
AGCCTACAAAG -> GCCTACAAAGG
CACGGGGCTAA -> ACGGGGCTAAG
GCAACCCCAGG -> CAACCCCAGGG
GCAGTGCCCTG -> CAGTGCCCTGT
CTCAGATGTGG -> TCAGATGTGGA
AGACGCGCGAA -> GACGCGCGAAC
TAATCTTCAGT -> AATCTTCAGTT
GTTTGCTACTA -> TTTGCTACTAG
GATGTACTCAT -> ATGTACTCATT
ATAGGATATAC -> TAGGATATACA
ACTACCGGATG -> CTACCGGATGT
TTCGTTTGTCT -> TCGTTTGTCTT
GGGCCCTGAAG -> GGCCCTGAAGT
TAGACTGTTCG -> AGACTGTTCGG
TGGGGTATGAT -> GGGGTATGATT
AACGATTCGTT -> ACGATTCGTTG
GTGCCAGTGGA -> TGCCAGTGGAT
GCTACGTACAC -> CTACGTACACT
GGGCTTGCAAC -> GGCTTGCAACC
TACGGGGCATC -> ACGGGGCATCG
TTCCACCCGAA -> TCCACCCGAAC
TCTCCTGTTCG -> CTCCTGTTCGT
CAAAGGCGCGA -> AAAGGCGCGAC
CGTTGCGAATA -> GTTGCGAATAA
GTGTCTTTCCC -> TGTCTTTCCCT
TCCCAGTGGCG -> CCCAGTGGCGC
TTAGTCCGGAG -> TAGTCCGGAGA
TAGCCCTGTGA -> AGCCCTGTGAC
CACGGTATGTA -> ACGGTATGTAA
CCTTCAGGGTA -> CTTCAGGGTAT
CGGGAACATAG -> GGGAACATAGA
TGTGAGTCGCA -> GTGAGTCGCAG
CTTGATCCCAG -> TTGATCCCAGT
CATGCGTTTAG -> ATGCGTTTAGT
GCTCGAGTGAA -> CTCGAGTGAAT
ATTTATACGGG -> TTTATACGGGG
TTTGTCTTAAC -> TTGTCTTAACA
TCCTGCATTCG -> CCTGCATTCGA
TGGCATGCGTT -> GGCATGCGTTT
ATTCTTTCACC -> TTCTTTCACCT
TAGACTCATCG -> AGACTCATCGA
ATGTAGACCGG -> TGTAGACCGGT
CTAAACGGGAC -> TAAACGGGACG
TGTACTCATTT -> GTACTCATTTC
AACAGTGCCGC -> ACAGTGCCGCG
GTGCAACCATA -> TGCAACCATAT
TTCATAAGTGG -> TCATAAGTGGA
TGCCAGTGGAT -> GCCAGTGGATT
ACGTCTTTGTT -> CGTCTTTGTTG
TTTCACCTTTC -> TTCACCTTTCG
TCTATATGGGG -> CTATATGGGGC
CGAAACGTCTT -> GAAACGTCTTT
ATTCGAGCTCT -> TTCGAGCTCTC
TTTTTTCACCT -> TTTTTCACCTT
GGCTCCTAGTT -> GCTCCTAGTTG
GATGTTTCTGC -> ATGTTTCTGCT
ACCAGTACCCA -> CCAGTACCCAT
ATTACCCACTT -> TTACCCACTTT
CCGACTTCAAT -> CGACTTCAATT
TGGCATCGGCT -> GGCATCGGCTG
AGCTGCGAATG -> GCTGCGAATGT
TATCTGATTAG -> ATCTGATTAGA
AGATACGTCGG -> GATACGTCGGC
AAATCCGAGCA -> AATCCGAGCAT
TCGGATTTCGT -> CGGATTTCGTG
TCCCGCGCATT -> CCCGCGCATTC
ACTTGTAAATA -> CTTGTAAATAC
GTGTCCGTTCG -> TGTCCGTTCGT
AGAGGTAGCCC -> GAGGTAGCCCT
TGTGCCAGTGG -> GTGCCAGTGGA
GGTCAGTCCGT -> GTCAGTCCGTA
GCATCTATGCC -> CATCTATGCCC
CACCCTGTTTC -> ACCCTGTTTCC
CATTGACAAAG -> ATTGACAAAGA
AGGCCTGTCTT -> GGCCTGTCTTC
GAGATGCGGCC -> AGATGCGGCCT
GTTCGTTATAT -> TTCGTTATATG
CGATATGTCCT -> GATATGTCCTG
CCCCGGAACAA -> CCCGGAACAAA
TGGCAACTATT -> GGCAACTATTT
TAGTGATTAGT -> AGTGATTAGTG
GTTGACACCAG -> TTGACACCAGT
CTACTAGACTC -> TACTAGACTCA
TTAGAACTCAA -> TAGAACTCAAC
ACAACCGCGAA -> CAACCGCGAAG
AATATTGGACT -> ATATTGGACTT
CTGTCTTCGAG -> TGTCTTCGAGA
ACATTGACAAA -> CATTGACAAAG
AGTTGACACCA -> GTTGACACCAG
ATCCACCGTGG -> TCCACCGTGGT
GTCCGTTCGTT -> TCCGTTCGTTT
TAGTTTTCAGG -> AGTTTTCAGGC
TGGTAAAGCCT -> GGTAAAGCCTA
ACCCAGGCGTG -> CCCAGGCGTGT
AGCGTTCTTAC -> GCGTTCTTACT
GCCTTCAGGGT -> CCTTCAGGGTA
TAGTAGGATTA -> AGTAGGATTAG
TTTAACAGCGT -> TTAACAGCGTT
CTGACTTAGAA -> TGACTTAGAAC
TTAAACGACCG -> TAAACGACCGC
GTTAACCGCGA -> TTAACCGCGAG
CGGATGTATAT -> GGATGTATATC
ACCCTGTTTCC -> CCCTGTTTCCC
CGTGTCTTTCC -> GTGTCTTTCCC
TCGGGCTTGCA -> CGGGCTTGCAA
CGTGGATGTTT -> GTGGATGTTTC
AGAGTAGCCTC -> GAGTAGCCTCA
CCCTGTGACTC -> CCTGTGACTCA
GCGAATTCCCC -> CGAATTCCCCG
GGATGTATATC -> GATGTATATCT
TTTTGTTACTT -> TTTGTTACTTG
ATTTGAGGCGT -> TTTGAGGCGTT
GTACGGTTATT -> TACGGTTATTA
CGCGATCGTGA -> GCGATCGTGAT
GTACTTGTCTA -> TACTTGTCTAG
GTTGTACGGTT -> TTGTACGGTTA
CCCGCGAATTC -> CCGCGAATTCC
CTTTAACTGCG -> TTTAACTGCGC
ACTACAAGATA -> CTACAAGATAG
GATTGGAACTT -> ATTGGAACTTA
CAACCCCAGGG -> AACCCCAGGGC
ATAGAAATTTA -> TAGAAATTTAT
TTTACCACGGT -> TTACCACGGTA
TATTTAATTAC -> ATTTAATTACT
TACCCACTTTT -> ACCCACTTTTT
CTCAGCGCTCG -> TCAGCGCTCGA
AAAGGCGCGAC -> AAGGCGCGACA
TTGCAACCCCA -> TGCAACCCCAG
TCGAGTAGAGT -> CGAGTAGAGTA
ACTTGATTAAC -> CTTGATTAACA
GATCGTACGTC -> ATCGTACGTCG
GGATGTTTCTG -> GATGTTTCTGC
GACTCATCGAT -> ACTCATCGATA
GTGCCCTGTCT -> TGCCCTGTCTG
CACCTTTCGCT -> ACCTTTCGCTA
TCGGCGCTTAG -> CGGCGCTTAGT
AGTCTTGGCAT -> GTCTTGGCATT
GGATATACACG -> GATATACACGA
AGACCGGTTGT -> GACCGGTTGTA
CCGAACTAGAG -> CGAACTAGAGA
GTGGACGGCGC -> TGGACGGCGCC
GATTAGTGCAA -> ATTAGTGCAAC
AGTCATGAGGG -> GTCATGAGGGG
GTGGGAGTCTC -> TGGGAGTCTCG
TTGTGCCAGTG -> TGTGCCAGTGG
CGAATGTGAGT -> GAATGTGAGTC
GGCCCAGTGTC -> GCCCAGTGTCC
GGACGGCGCCA -> GACGGCGCCAT
AACTGCGCCGA -> ACTGCGCCGAC
TTCTCGATTGG -> TCTCGATTGGA
TGGTTTTTTCA -> GGTTTTTTCAC
CTTAGTAGGAT -> TTAGTAGGATT
GTCGCAGATAT -> TCGCAGATATG
TATTAATAATA -> ATTAATAATAA
CCGAGCACTGC -> CGAGCACTGCC
CAGTACCCATG -> AGTACCCATGT
CCGCTCCCTGT -> CGCTCCCTGTC
TATCCCTCTTC -> ATCCCTCTTCA
CCCTGTCACGC -> CCTGTCACGCC
GGTGTAGGCCC -> GTGTAGGCCCA
AAAGGATCTTC -> AAGGATCTTCG
TTAACCTTTAA -> TAACCTTTAAC
CAGGAACAGTG -> AGGAACAGTGC
CTATATGGGGC -> TATATGGGGCA
GTTGGGAGTTT -> TTGGGAGTTTC
ATCGACATTGA -> TCGACATTGAC
AGAACTACTAG -> GAACTACTAGA
AGCAGTATAAA -> GCAGTATAAAC
TAATAATAAAA -> AATAATAAAAG
CCGCCCGAAAC -> CGCCCGAAACG
TAGGCTCCTAG -> AGGCTCCTAGT
ATTCGGTCCTC -> TTCGGTCCTCC
TGTCAGTACCG -> GTCAGTACCGA
GTTAAACGACC -> TTAAACGACCG
CAAGTAGGTTG -> AAGTAGGTTGT
CGACCGGGCCC -> GACCGGGCCCT
ATTTTGTTACT -> TTTTGTTACTT
GTGGATGTTTC -> TGGATGTTTCT
TACTTGATTAA -> ACTTGATTAAC
TGTGATATAAG -> GTGATATAAGT
ATGTGGATTGA -> TGTGGATTGAC
TTAGGCGATGT -> TAGGCGATGTA
AGCATCTATAA -> GCATCTATAAT
TACTTGTAAAT -> ACTTGTAAATA
AGAAGGTAAAG -> GAAGGTAAAGA
GGGCCATGTTC -> GGCCATGTTCT
AAACGGGACGA -> AACGGGACGAT
ACCAGTCATCC -> CCAGTCATCCG
ACACTGGGGAC -> CACTGGGGACT
CGCTCAGCGCT -> GCTCAGCGCTC
TGACTTAGAAC -> GACTTAGAACT
GCACATCCCGC -> CACATCCCGCG
TAAACGACCGC -> AAACGACCGCG
CCTTGGCAACT -> CTTGGCAACTA
CCGTGATTCTT -> CGTGATTCTTC
CGCTCCCTGTC -> GCTCCCTGTCA
ATATACACGAA -> TATACACGAAA
TTCTTACTCGT -> TCTTACTCGTG
TGTGGGAGTCT -> GTGGGAGTCTC
TCTACTGGGCG -> CTACTGGGCGA
GTTTTAGTAGA -> TTTTAGTAGAC
ACGCCTTCAGG -> CGCCTTCAGGG
TACCGGATGTA -> ACCGGATGTAT
GACGTGGATGT -> ACGTGGATGTT
TCTGCCAGGTG -> CTGCCAGGTGC
TTCTAGTGATT -> TCTAGTGATTA
TCTTTCCCTTC -> CTTTCCCTTCG
AATCATCGACA -> ATCATCGACAT
CCGTTCGTTTG -> CGTTCGTTTGT
GTTTCATAAGT -> TTTCATAAGTG
TGTCTTTCCCT -> GTCTTTCCCTT
CCGAAAGCCAT -> CGAAAGCCATA
TTGTGGGAGTC -> TGTGGGAGTCT
TACACAACCGC -> ACACAACCGCG
ACAAAGGCGCG -> CAAAGGCGCGA
CCGGTTTGCTA -> CGGTTTGCTAC
AGGGGCGCCTA -> GGGGCGCCTAC
ATGTAACACCC -> TGTAACACCCG
GCGGCCTTGAT -> CGGCCTTGATC
CTTTGTTGCCG -> TTTGTTGCCGG
CCAGTGGCGCT -> CAGTGGCGCTT
TAGCCCAATTG -> AGCCCAATTGA
AAACGGGAACA -> AACGGGAACAT
GTACACTACTT -> TACACTACTTG
GACTACAAGAT -> ACTACAAGATA
CGTCGGCGCTT -> GTCGGCGCTTA
AAGACACTGGG -> AGACACTGGGG
CTAGCCCAATT -> TAGCCCAATTG
TTAATTACTTG -> TAATTACTTGG
TTCCAGCAGTA -> TCCAGCAGTAT
CTTGGAGGAAC -> TTGGAGGAACA
ACTAATAACAC -> CTAATAACACC
TATGTAACACC -> ATGTAACACCC
GTAGCCCTGTG -> TAGCCCTGTGA
ACTCATCGATA -> CTCATCGATAA
GCAGCATCTAT -> CAGCATCTATA
TGGGCTCCTCC -> GGGCTCCTCCG
TTTTCGACCGG -> TTTCGACCGGG
GACCGCGGACG -> ACCGCGGACGC
TGCGTTTAGTT -> GCGTTTAGTTT
CTAAATCATCG -> TAAATCATCGA
ATAGCACATCC -> TAGCACATCCC
GCTTTACCACG -> CTTTACCACGG
CTCGAGTGAAT -> TCGAGTGAATT
GATCCCAGTGG -> ATCCCAGTGGC
TGACGAGTGTC -> GACGAGTGTCC
ATCTTCGGATT -> TCTTCGGATTT
CTGCTCATCGC -> TGCTCATCGCG
TTATGGGCTCC -> TATGGGCTCCT
GAGGTAGCCCT -> AGGTAGCCCTG
ATCCCTCTTCA -> TCCCTCTTCAC
GCGTTCTTACT -> CGTTCTTACTC
TTGTTACTTGA -> TGTTACTTGAT
CCGACATGTTG -> CGACATGTTGA
GTCATGAGGGG -> TCATGAGGGGC
GGCTTGCAACC -> GCTTGCAACCC
CCAGTACCCAT -> CAGTACCCATG
ACGGGGCATCG -> CGGGGCATCGG
CGAGTTCTCCA -> GAGTTCTCCAG
GCGAACCAGTA -> CGAACCAGTAC
GCCATAGCACA -> CCATAGCACAT
TCTCGTAACAT -> CTCGTAACATG
CTCCGCCCGAA -> TCCGCCCGAAA
AGGTTCGAGTA -> GGTTCGAGTAG
GTAGCCTCACA -> TAGCCTCACAC
ACCTTGGCAAC -> CCTTGGCAACT
TGTCTGCAGTC -> GTCTGCAGTCT
TTTCACCTTTT -> TTCACCTTTTC
ATTCGTTGGGA -> TTCGTTGGGAG
CAGATTCGGTC -> AGATTCGGTCC
CCGAGCATTCG -> CGAGCATTCGT
CTCTCCTCTCC -> TCTCCTCTCCT
ATACGTCGGCG -> TACGTCGGCGC
CATGAGGGGCG -> ATGAGGGGCGC
AATCTGGCTTT -> ATCTGGCTTTG
GGAACGTTGCG -> GAACGTTGCGA
AACCGCGAAGC -> ACCGCGAAGCA
GACCTACGGTG -> ACCTACGGTGT
GAACCAGTACC -> AACCAGTACCC
TAACATGCAGA -> AACATGCAGAT
CAGGTGTGATA -> AGGTGTGATAT
AGGGGCCATGT -> GGGGCCATGTT
TTTCATAAGTG -> TTCATAAGTGG
CATCGGCATCA -> ATCGGCATCAG
CGTCTTTGTTG -> GTCTTTGTTGC
GTCGAGGTGGC -> TCGAGGTGGCT
CCATCCAACGA -> CATCCAACGAT
AGGCGATGTAC -> GGCGATGTACT
CTTCGCAGTGC -> TTCGCAGTGCC
ACACCAGTCAT -> CACCAGTCATC
ATCCAACGATT -> TCCAACGATTC
TTAGATACGTC -> TAGATACGTCG
CGCGAACCAGT -> GCGAACCAGTA
TGAATTTCTGC -> GAATTTCTGCA
CCGAAACGTCT -> CGAAACGTCTT
ACATCGGCATC -> CATCGGCATCA
AACTTAGAAGG -> ACTTAGAAGGT
GAACAAATGCC -> AACAAATGCCC
ACCCACTTTTT -> CCCACTTTTTC
GTAGACCGGTT -> TAGACCGGTTG
GCTTAGTAGGA -> CTTAGTAGGAT
TCCAGCAGTAT -> CCAGCAGTATA
CGTTTGTCTTA -> GTTTGTCTTAA
GCCCAGTGTCC -> CCCAGTGTCCG
CTCTTCACCTT -> TCTTCACCTTA
CGATTGTTACA -> GATTGTTACAA
AACGACCGCGG -> ACGACCGCGGA
CTTGTCTAGTG -> TTGTCTAGTGA
CGTGGTTAAAC -> GTGGTTAAACG
CCATATCCCTC -> CATATCCCTCT
AGTGGAAAGAG -> GTGGAAAGAGT
CAGGGTATGAT -> AGGGTATGATT
TTTTACGTGTC -> TTTACGTGTCT
GCTCCTGTCAA -> CTCCTGTCAAG
GAAAACGGGAA -> AAAACGGGAAC
TTCTTTCACCT -> TCTTTCACCTT
TGGAAAGAGTT -> GGAAAGAGTTG
GATACGTCGGC -> ATACGTCGGCG
ACATGTTGAAA -> CATGTTGAAAT
CCATACGCTCG -> CATACGCTCGG
GGAGACGCGAG -> GAGACGCGAGG
TCCCTTCGTTA -> CCCTTCGTTAG
TTACGTGTCTG -> TACGTGTCTGC
CTGCGAATGTG -> TGCGAATGTGA
TAAGTGGAAAG -> AAGTGGAAAGA
TGTTGAAATCT -> GTTGAAATCTT
CATGTTAACCG -> ATGTTAACCGC
CTCCTCTCCTG -> TCCTCTCCTGT
ACAAATGCCCA -> CAAATGCCCAT
GGCAACTATTT -> GCAACTATTTA
GGAACAAATGC -> GAACAAATGCC
ACTTGGGGTAT -> CTTGGGGTATG
TGTTACTTGAT -> GTTACTTGATT
TTACGATATGT -> TACGATATGTC
ACAAGATAGAA -> CAAGATAGAAA
GTGGTGTAGGC -> TGGTGTAGGCC
ATCTCAATGGC -> TCTCAATGGCA
TTATATGAGTA -> TATATGAGTAT
ACTTGTCTAGT -> CTTGTCTAGTG
ATAACACCATT -> TAACACCATTG
CATGTATTCGA -> ATGTATTCGAA
CAGTCTTGGCA -> AGTCTTGGCAT
GAGGAACACGG -> AGGAACACGGG
TTCGAGAGATG -> TCGAGAGATGC
AAGAGTTGGTT -> AGAGTTGGTTT
TTAGTCGAGGT -> TAGTCGAGGTG
GCAGATTCGGT -> CAGATTCGGTC
TGGCAGCATCT -> GGCAGCATCTA
TTCGTTGGGAG -> TCGTTGGGAGT
CGAGCTCTATA -> GAGCTCTATAT
TGCCGCGATCG -> GCCGCGATCGT
CGTACGTCGCT -> GTACGTCGCTC
AGTACCGAGTT -> GTACCGAGTTC
TGTACTTGTCT -> GTACTTGTCTA
CGAGTGAATTT -> GAGTGAATTTC
CGCCGACATGT -> GCCGACATGTT
TTCGGGTGGAC -> TCGGGTGGACG
ATTGTTACAAT -> TTGTTACAATA
CGAAGTAACCG -> GAAGTAACCGG
GCGTGTCTTTC -> CGTGTCTTTCC
ATTAGTGCAAC -> TTAGTGCAACC
CATCGGGCTGA -> ATCGGGCTGAG
TAATATTGGAC -> AATATTGGACT
AAGTGGAAAGA -> AGTGGAAAGAG
ATGTTGAAATC -> TGTTGAAATCT
TCGAGTGAATT -> CGAGTGAATTT
CTTAGAACTCA -> TTAGAACTCAA
GTGTGATATAA -> TGTGATATAAG
GGATTAATATT -> GATTAATATTG
GAACGTTGTGC -> AACGTTGTGCC
TCGTGATCATG -> CGTGATCATGT
ATCTGGCTTTG -> TCTGGCTTTGG
CCCCGCGAATT -> CCCGCGAATTC
TTCCCTTCGTT -> TCCCTTCGTTA
TCAGATGTGGA -> CAGATGTGGAT
GGTGTATGAGA -> GTGTATGAGAT
GACGCGCGAAC -> ACGCGCGAACT
GCGTTTAGTTT -> CGTTTAGTTTT
GGCGATGTACT -> GCGATGTACTC
CGTTCTTACTC -> GTTCTTACTCG
CGAGCACTGCC -> GAGCACTGCCA
AGGCCCAGTGT -> GGCCCAGTGTC
GGTTTTTTCAC -> GTTTTTTCACC
TGTAATTCGGT -> GTAATTCGGTT
CCCATCCAACG -> CCATCCAACGA
GAAAGCCATAC -> AAAGCCATACG
ATATTGGACTT -> TATTGGACTTA
GATTGTGGCAT -> ATTGTGGCATG
TAACACATCGG -> AACACATCGGC
ACCTTAGTCCG -> CCTTAGTCCGG
TGCAGTCTTGG -> GCAGTCTTGGC
AAGGACCTACG -> AGGACCTACGG
ATTAACACATC -> TTAACACATCG
GTTCGGGTGGA -> TTCGGGTGGAC
CAGTGCCCTGT -> AGTGCCCTGTC
TTTGATGGAAC -> TTGATGGAACG
TGAAGTTGGCA -> GAAGTTGGCAG
ACACTAATAAC -> CACTAATAACA
GTTTTCAGGCC -> TTTTCAGGCCT
GGCTGAGGATT -> GCTGAGGATTA
AGTGGATTGTG -> GTGGATTGTGG
TGATTAGATAC -> GATTAGATACG
GGGGTATGATT -> GGGTATGATTC
GTAACCGGACT -> TAACCGGACTA
TAAATCATCGA -> AAATCATCGAC
GATAAATCTGG -> ATAAATCTGGC
TACAATATGTA -> ACAATATGTAG
GAGGACCGAGC -> AGGACCGAGCC
CGGTTGTTAGC -> GGTTGTTAGCC
TGTTTCCCGTT -> GTTTCCCGTTT
TGACTCAGGTG -> GACTCAGGTGT
CCCTTCGTTAG -> CCTTCGTTAGG
ACAACCTCAGA -> CAACCTCAGAT
TGTGGCATGCG -> GTGGCATGCGT
TCCACCGTGGT -> CCACCGTGGTG
AGGACCGAGCC -> GGACCGAGCCA
CCGCGAAGCAT -> CGCGAAGCATC
CCGGATCGTAC -> CGGATCGTACG
GTTGCGAATAA -> TTGCGAATAAA
TATTGGACTTA -> ATTGGACTTAA
TTCAGGCCTGT -> TCAGGCCTGTC
GCCTACAAAGG -> CCTACAAAGGC
ACTTAACCTTG -> CTTAACCTTGG
GATTGACTACA -> ATTGACTACAA
TTCACCTTTCG -> TCACCTTTCGC
AGAGAACGTTG -> GAGAACGTTGT
CAGTACCGAGT -> AGTACCGAGTT
CGTTAGGCGAT -> GTTAGGCGATG
TAACTGCGCCG -> AACTGCGCCGA
ATCATGACTTG -> TCATGACTTGT
TAAACCTACAC -> AAACCTACACA
CAGACGTGGAT -> AGACGTGGATG
GCCATGTTCTA -> CCATGTTCTAG
GAAGCTGCGAA -> AAGCTGCGAAT
ATGTGAGTCGC -> TGTGAGTCGCA
TTGGCAGCATC -> TGGCAGCATCT
GTTGCTTTACC -> TTGCTTTACCA
CCGCGATCGTG -> CGCGATCGTGA
GGAGGAACACG -> GAGGAACACGG
AACAGACGTGG -> ACAGACGTGGA
CTACCGGATGT -> TACCGGATGTA
AAGCTGCGAAT -> AGCTGCGAATG
TCCCACCCTGT -> CCCACCCTGTT
CGATTCGTTGG -> GATTCGTTGGG
ATGCAGATTCG -> TGCAGATTCGG
ACTAGACTCAT -> CTAGACTCATC
TTAATAATAAA -> TAATAATAAAA
GGATCTTCGGA -> GATCTTCGGAT
GATCCACCGTG -> ATCCACCGTGG
GCCTTGATCCC -> CCTTGATCCCA
AAGCCATACGC -> AGCCATACGCT
GCGTTGTGCAT -> CGTTGTGCATC
GTTTTACGTGT -> TTTTACGTGTC
CTTCGAGAGAT -> TTCGAGAGATG
CGAACCAGTAC -> GAACCAGTACC
CACGCCGAGCA -> ACGCCGAGCAC
GAGTCTACTGG -> AGTCTACTGGG
GGGAACATAGA -> GGAACATAGAT
GCCTACTTGGG -> CCTACTTGGGG
CCACTTTTTCG -> CACTTTTTCGA
GAGTATGTCAG -> AGTATGTCAGT
GTGCTCCTGTC -> TGCTCCTGTCA
TCCGTGATTCT -> CCGTGATTCTT
AGAGCTCCCTA -> GAGCTCCCTAA
GTAGGCCCAGT -> TAGGCCCAGTG
TATGAGATCCA -> ATGAGATCCAC
ATAAATCTGGC -> TAAATCTGGCT
GCGCGAACTGG -> CGCGAACTGGA
TCGGCTGTCCG -> CGGCTGTCCGT
ACCACGGTATG -> CCACGGTATGT
ATCCGAGCATT -> TCCGAGCATTC
TAACCGGACTA -> AACCGGACTAT
GACGCGAGGCA -> ACGCGAGGCAA
GGGCTGAGGAT -> GGCTGAGGATT
TTTCCCGTTTT -> TTCCCGTTTTA
GAGTTGGTTTT -> AGTTGGTTTTT
GCGTTTGATGG -> CGTTTGATGGA
TGTTACAATAT -> GTTACAATATG
GGTATGATTCT -> GTATGATTCTT,GTATGATTCTC
ATCTTGGAGGA -> TCTTGGAGGAA
CCAGTCATCCG -> CAGTCATCCGC
CGGGGCATCGG -> GGGGCATCGGG
CATGACTTGTG -> ATGACTTGTGG
AATCCGAGCAT -> ATCCGAGCATT
ATGTTTCTGCT -> TGTTTCTGCTC
CCTGTCAAGGT -> CTGTCAAGGTT
ACAGACGTGGA -> CAGACGTGGAT
AAGTATTTTGT -> AGTATTTTGTT
GCATTAGTCGA -> CATTAGTCGAG
GTCAGTACCGA -> TCAGTACCGAG
CGCTTAGTAGG -> GCTTAGTAGGA
GAGCTCCCTAA -> AGCTCCCTAAA
CATATCCCTCT -> ATATCCCTCTT
TGATGGAACGT -> GATGGAACGTT
TAACCTTGGCA -> AACCTTGGCAA
GTTTAACAGCG -> TTTAACAGCGT
GGCCGAGCGCG -> GCCGAGCGCGG
TTTGCTACTAG -> TTGCTACTAGT
GCACTGCCAGT -> CACTGCCAGTC
CTGATTAGATA -> TGATTAGATAC
CCAACGATTCG -> CAACGATTCGT
CGGCGCTTAGT -> GGCGCTTAGTA
TCCACCCGAAC -> CCACCCGAACT
AACGCTCAGCG -> ACGCTCAGCGC
ACGCTCGGGCT -> CGCTCGGGCTT
GTGCATCTATG -> TGCATCTATGC
CCTGTTTCCCG -> CTGTTTCCCGT
CCAGGCGTGTC -> CAGGCGTGTCT
TGCGCCGACAT -> GCGCCGACATG
TGATTCTTTCA -> GATTCTTTCAC
CATACGCTCGG -> ATACGCTCGGG
GAACTGGAGAG -> AACTGGAGAGG
CGTTGTGCATC -> GTTGTGCATCT
GCTCCTCCGCC -> CTCCTCCGCCC
TTGCGAATAAA -> TGCGAATAAAT
CAGGTGCTCCT -> AGGTGCTCCTG
TTCGAGCTCTC -> TCGAGCTCTCC
CGGGGCTAAGG -> GGGGCTAAGGC
GACAAAGAAGC -> ACAAAGAAGCT
ATGACTTGTGG -> TGACTTGTGGG
CCCTGTTTCCC -> CCTGTTTCCCG
TGACTACAAGA -> GACTACAAGAT
TGTCTGACTTA -> GTCTGACTTAG
CTTCACCTTAG -> TTCACCTTAGT
ATCCCAGTGGC -> TCCCAGTGGCG
TAGATGGTAGT -> AGATGGTAGTG
CATCAGGTTGC -> ATCAGGTTGCT
CACCTTTTCGT -> ACCTTTTCGTA
GTCTGACTTAG -> TCTGACTTAGA
CAACTATTTAA -> AACTATTTAAT
TTCGTTAGGCG -> TCGTTAGGCGA
TTCGTGAGAGC -> TCGTGAGAGCT
GTTTGATGGAA -> TTTGATGGAAC
GCTCTATATGG -> CTCTATATGGG
CTAGAGAACGT -> TAGAGAACGTT
ACACTACTTGT -> CACTACTTGTA
GGATTTCGTGA -> GATTTCGTGAG
ACTAGTTTTAC -> CTAGTTTTACG
CAACAGACGTG -> AACAGACGTGG
CGGGCCCTGAA -> GGGCCCTGAAG
TTGACGAGTGT -> TGACGAGTGTC
TTGGCAAGGAC -> TGGCAAGGACC
GTACCGAGTTC -> TACCGAGTTCT
TTGTGCATCTA -> TGTGCATCTAT
GTATGTAATTC -> TATGTAATTCG
AAATCTGGCTT -> AATCTGGCTTT
CCTCTCCTGTT -> CTCTCCTGTTC
CTATGCCCCAC -> TATGCCCCACA
TTGACACCAGT -> TGACACCAGTC
GCTTCCAGCAG -> CTTCCAGCAGT
GAGACGCGAGG -> AGACGCGAGGC
ACTGCCAGTCA -> CTGCCAGTCAT
AAGGCGCGACA -> AGGCGCGACAA
GTTGGCAGCAT -> TTGGCAGCATC
GGGCATCGGGC -> GGCATCGGGCT
TGCATTCGAGC -> GCATTCGAGCT
GCTCTCCTCTC -> CTCTCCTCTCC
CTACGTACACT -> TACGTACACTA
ACGCCGAGCAC -> CGCCGAGCACT
TTGGTTTTTTC -> TGGTTTTTTCA
GATTCGTTGGG -> ATTCGTTGGGA
TTTCCCACCCT -> TTCCCACCCTG
GATATAAGTAT -> ATATAAGTATT
TGATTAGTGCA -> GATTAGTGCAA
TGGTCAGTCCG -> GGTCAGTCCGT
GGACTACCGGA -> GACTACCGGAT
GTCCGGAGACG -> TCCGGAGACGC
CTGCATTCGAG -> TGCATTCGAGC
CGTGGTGTAGG -> GTGGTGTAGGC
ACTGGGGACTA -> CTGGGGACTAC
AGGGCCGAGCG -> GGGCCGAGCGC
ATGGTAGTGGA -> TGGTAGTGGAA
AATAATAAAAG -> ATAATAAAAGG
TACGATATGTC -> ACGATATGTCC
AGACTGTTCGG -> GACTGTTCGGG
GGCCATGTTCT -> GCCATGTTCTA
TTACAATATGT -> TACAATATGTA
AACAAATGCCC -> ACAAATGCCCA
ACGATATGTCC -> CGATATGTCCT
CATTATGGGCT -> ATTATGGGCTC
ATGCCCCACAA -> TGCCCCACAAG
CACCGTGGTGT -> ACCGTGGTGTA
GGTGGCTACGT -> GTGGCTACGTA
CTCCTCCGCCC -> TCCTCCGCCCG
CCAGGAACAGT -> CAGGAACAGTG
TCCGCCCGAAA -> CCGCCCGAAAC
TGACAAAGAAG -> GACAAAGAAGC
CATTCGTCGAG -> ATTCGTCGAGT
CGATAGGATAT -> GATAGGATATA
TGTCTTCGAGA -> GTCTTCGAGAG
TCCCTCTTCAC -> CCCTCTTCACC
ACGCGAGGCAA -> CGCGAGGCAAA
GGACCTACGGT -> GACCTACGGTG
CGTTTGATGGA -> GTTTGATGGAA
CTTGGCAACTA -> TTGGCAACTAT
AGCTCTATATG -> GCTCTATATGG
CACGAAAACGG -> ACGAAAACGGG
CTTACTCGTGG -> TTACTCGTGGT
GAATTCCCCGG -> AATTCCCCGGA
CTTCTGCCAGG -> TTCTGCCAGGT
GTCCGGATCGT -> TCCGGATCGTA
CCATTGGTAAA -> CATTGGTAAAG
CTCCCCCAGGA -> TCCCCCAGGAA
CTGCATGGCGT -> TGCATGGCGTT
TAATAACACCA -> AATAACACCAT
ACCTTTTCGTA -> CCTTTTCGTAT
ATCGTGATCAT -> TCGTGATCATG
TCGGTCCTCCC -> CGGTCCTCCCC
GAAGTTGGCAG -> AAGTTGGCAGC
GAGAACGTTGT -> AGAACGTTGTG
TCCGTAGACGC -> CCGTAGACGCG
TGTTCGGGTGG -> GTTCGGGTGGA
TCGCGAACCAG -> CGCGAACCAGT
GAGCTCTCCTC -> AGCTCTCCTCT
GTATATCTGAT -> TATATCTGATT
GCTTTGGTCAG -> CTTTGGTCAGT
CGCGACAACCT -> GCGACAACCTC
TTGGCAACTAT -> TGGCAACTATT
TGGCAAGGACC -> GGCAAGGACCT
CACCAGTCATC -> ACCAGTCATCC
ACACGGGGCTA -> CACGGGGCTAA
TAAAGCCTACA -> AAAGCCTACAA
AATGCCCATCC -> ATGCCCATCCA
ATGAGGGGCGC -> TGAGGGGCGCC
GTATGATTCTT -> TATGATTCTTT
TTTATACGGGG -> TTATACGGGGC
TCCCTGTCACG -> CCCTGTCACGC
AAATACGAAGT -> AATACGAAGTA
GCGCTTAGTAG -> CGCTTAGTAGG
CAGCATCTATA -> AGCATCTATAA
TTGGTCAGTCC -> TGGTCAGTCCG
CGGAACAAATG -> GGAACAAATGC
GTTGTACTTGT -> TTGTACTTGTC
GTAGTGGAAAG -> TAGTGGAAAGT
CGGTTAACCTT -> GGTTAACCTTT
ATTAATAATAA -> TTAATAATAAA
GCATTCGTCGA -> CATTCGTCGAG
TTGCTACTAGT -> TGCTACTAGTT
GAGGATTAATA -> AGGATTAATAT
CATCGATAAAT -> ATCGATAAATC
AACACGGGGCT -> ACACGGGGCTA
TCCGTTCGTTT -> CCGTTCGTTTG
TCGTGAGAGCT -> CGTGAGAGCTC
GCTGTCCGTGA -> CTGTCCGTGAT
TGCTACTAGTT -> GCTACTAGTTT
AAGTAACCGGA -> AGTAACCGGAC
TCACCTTTTCG -> CACCTTTTCGT
AGCCCTGTGAC -> GCCCTGTGACT
TTGCTTTACCA -> TGCTTTACCAC
TTCTGCATGGC -> TCTGCATGGCG
CATGCAGATTC -> ATGCAGATTCG
GAATAAATCCG -> AATAAATCCGA
GGCGAGGACCG -> GCGAGGACCGA
TAGAAGGTAAA -> AGAAGGTAAAG
GTTAGGCGATG -> TTAGGCGATGT
GATATGTAACA -> ATATGTAACAC
TGGATGTTTCT -> GGATGTTTCTG
TGGTGTAGGCC -> GGTGTAGGCCC
AGGCTGCTCAT -> GGCTGCTCATC
TAGATACGTCG -> AGATACGTCGG
AAACGTCTTTG -> AACGTCTTTGT
TGGGGACTACC -> GGGGACTACCG
TCCCCGGAACA -> CCCCGGAACAA
AGTTTCATAAG -> GTTTCATAAGT
GAACATAGATG -> AACATAGATGG
CGAAGCATCAC -> GAAGCATCACA
TATAAGTATTT -> ATAAGTATTTT
GTTAACCTTTA -> TTAACCTTTAA
CCGGAACAAAT -> CGGAACAAATG
CCTAAACGGGA -> CTAAACGGGAC
GCTGCGAATGT -> CTGCGAATGTG
CACTTTTTCGA -> ACTTTTTCGAC
ACCGAGCCATT -> CCGAGCCATTA
GATCTTCGGAT -> ATCTTCGGATT
CAACCTCAGAT -> AACCTCAGATG
GCCATACGCTC -> CCATACGCTCG
GACATTGACAA -> ACATTGACAAA
GATGCGGCCTT -> ATGCGGCCTTG
TTGTTGCCGGT -> TGTTGCCGGTT
TATGTCCTGCA -> ATGTCCTGCAT
TCTTACTCGTG -> CTTACTCGTGG
GCAAGGACCTA -> CAAGGACCTAC
TAACATCCGAC -> AACATCCGACT
ATTAGTCGAGG -> TTAGTCGAGGT
GATTAACACAT -> ATTAACACATC
ACACCATTGGT -> CACCATTGGTA
AGTCGCAGATA -> GTCGCAGATAT
GTACCCATGTT -> TACCCATGTTA
ATGATTCTTTC -> TGATTCTTTCA
GACACTGGGGA -> ACACTGGGGAC
TCTTCAGTTTA -> CTTCAGTTTAA
AATTCCCCGGA -> ATTCCCCGGAA
GCCAGGTGCTC -> CCAGGTGCTCC
ATCGTACGTCG -> TCGTACGTCGC
ACCGGATGTAT -> CCGGATGTATA
ACGCGCGAACT -> CGCGCGAACTG
GGAAAGAGTTG -> GAAAGAGTTGG
AGACGCGAGGC -> GACGCGAGGCA
CGCGAATTCCC -> GCGAATTCCCC
CCTCACACTAA -> CTCACACTAAT
CTGTCTGACTT -> TGTCTGACTTA
TCATGAGGGGC -> CATGAGGGGCG
ATCATCGACAT -> TCATCGACATT
TTTCTGCATGG -> TTCTGCATGGC
TACGTCGGCGC -> ACGTCGGCGCT
TACGTGTCTGC -> ACGTGTCTGCA
CTATAATCTTC -> TATAATCTTCA
CCCGAAAGCCA -> CCGAAAGCCAT
AACATCCGACT -> ACATCCGACTT
GGTTCGAGTAG -> GTTCGAGTAGA
CAGTGGCGCTT -> AGTGGCGCTTC
GTTTTTTCACC -> TTTTTTCACCT
CGAAAACGGGA -> GAAAACGGGAA
ATTCTTCGCAG -> TTCTTCGCAGT
TGTCCGTTCGT -> GTCCGTTCGTT
CGATAAATCTG -> GATAAATCTGG
CGTAACATGCA -> GTAACATGCAG
GGCATCGGCTG -> GCATCGGCTGT
TTTAGTAGACT -> TTAGTAGACTG
CTTCAGGGTAT -> TTCAGGGTATG
ACTACTTGTAA -> CTACTTGTAAA
ATATCCCTCTT -> TATCCCTCTTC
AGTGAAACGCT -> GTGAAACGCTC
GTCCTGCATTC -> TCCTGCATTCG
TAGTCCGGAGA -> AGTCCGGAGAC
GGGAGTTTCAT -> GGAGTTTCATA
GTTCGTTTGTC -> TTCGTTTGTCT
TTTTCAGGCCT -> TTTCAGGCCTG
TAAACGGGACG -> AAACGGGACGA
ACGGCGCCATA -> CGGCGCCATAG
TCGTTGGGAGT -> CGTTGGGAGTT
CTTGATTAACA -> TTGATTAACAC
GCTAAGGCTGC -> CTAAGGCTGCT
CGACTTCAATT -> GACTTCAATTA
TATGATTCTCG -> ATGATTCTCGA
TCAATTACCCA -> CAATTACCCAC
ATAATAAAAGG -> TAATAAAAGGA
CTGGGGACTAC -> TGGGGACTACC
CAGTGCCGCGA -> AGTGCCGCGAT
AGTCATCCGCT -> GTCATCCGCTC
TATATGAGTAT -> ATATGAGTATG
GCATCACATTA -> CATCACATTAT
TCGGTTAACCT -> CGGTTAACCTT
CAGGGCCGAGC -> AGGGCCGAGCG
TTAACCGCGAG -> TAACCGCGAGC
TCGTAACATGC -> CGTAACATGCA
AAAGTAGGCTC -> AAGTAGGCTCC
TTTTTCACCTT -> TTTTCACCTTT
CCTGTGACTCA -> CTGTGACTCAG
ATTAGATACGT -> TTAGATACGTC
ACACCCGAAAG -> CACCCGAAAGC
CCCGAACTAGA -> CCGAACTAGAG
GGGACTACCGG -> GGACTACCGGA
TACGGTGTATG -> ACGGTGTATGA
GCGCCTACTTG -> CGCCTACTTGG
TGGAACGTTGC -> GGAACGTTGCG
TTTCGTGAGAG -> TTCGTGAGAGC
TCCGAGCATTC -> CCGAGCATTCG
CGAGAGATGCG -> GAGAGATGCGG
TACTGGGCGAG -> ACTGGGCGAGG
TCTGACTTAGA -> CTGACTTAGAA
CGAACTGGAGA -> GAACTGGAGAG
CGGCTGTCCGT -> GGCTGTCCGTG
TTGTCTTAACA -> TGTCTTAACAT
GGGCGAGGACC -> GGCGAGGACCG
TCCTCTCCTGT -> CCTCTCCTGTT
GTCAGTCCGTA -> TCAGTCCGTAG
TGAGAGCTCCC -> GAGAGCTCCCT
CACAACCGCGA -> ACAACCGCGAA
ACCGCGAGCTC -> CCGCGAGCTCT
TATGTAGACCG -> ATGTAGACCGG
AAACGCTCAGC -> AACGCTCAGCG
TCTGCATGGCG -> CTGCATGGCGT
GCCGAGCGCGG -> CCGAGCGCGGA
ATTTCTGCATG -> TTTCTGCATGG
CGATGTACTCA -> GATGTACTCAT
CCAGGTGCTCC -> CAGGTGCTCCT
CTACGGTGTAT -> TACGGTGTATG
ATTAGGGGCCA -> TTAGGGGCCAT
ATGGCGTTGTG -> TGGCGTTGTGC
TTTTAGTAGAC -> TTTAGTAGACT
ATGCCCATCCA -> TGCCCATCCAA
ACTTCAATTAC -> CTTCAATTACC
TCTAGTGATTA -> CTAGTGATTAG
CTGCAGTCTTG -> TGCAGTCTTGG
TTCCCCGGAAC -> TCCCCGGAACA
TCATCATGACT -> CATCATGACTT
CGGCATCAGGT -> GGCATCAGGTT
CTACTTGGGGT -> TACTTGGGGTA
TGTATGAGATC -> GTATGAGATCC
TTACTTGATTA -> TACTTGATTAA
TCTTCGGATTT -> CTTCGGATTTC
CTACACAACCG -> TACACAACCGC
TGCCGGTTTGC -> GCCGGTTTGCT
CCTCTTCACCT -> CTCTTCACCTT
ATTATTAATAA -> TTATTAATAAT
CTAAGGCTGCT -> TAAGGCTGCTC
TACACTACTTG -> ACACTACTTGT
TCGATAAATCT -> CGATAAATCTG
GATCGTGATCA -> ATCGTGATCAT
TGCTCGATAGG -> GCTCGATAGGA
AGTAGGTTGTT -> GTAGGTTGTTT
CGCTAGCCCAA -> GCTAGCCCAAT
GTTGTTAGCCC -> TTGTTAGCCCC
GTTAGCCCCGC -> TTAGCCCCGCG
ACTATTTAATT -> CTATTTAATTA
TCAACAGACGT -> CAACAGACGTG
GAACGTTGCGA -> AACGTTGCGAA
AACCTTTAACT -> ACCTTTAACTG
CGCCTTCAGGG -> GCCTTCAGGGT
GTCTTAACATC -> TCTTAACATCC
GGTAGCCCTGT -> GTAGCCCTGTG
ACACGAAAACG -> CACGAAAACGG
TGTAGACCGGT -> GTAGACCGGTT
AACTGGAGAGG -> ACTGGAGAGGT
GCGATCGTGAT -> CGATCGTGATC
GAACTACTAGA -> AACTACTAGAC
TTCTGCCAGGT -> TCTGCCAGGTG
GCTCATCGCGA -> CTCATCGCGAA
GGAACTTAGAA -> GAACTTAGAAG
CCGTTTTAGTA -> CGTTTTAGTAG
TACTTGGCAAG -> ACTTGGCAAGG
GTCTCGTAACA -> TCTCGTAACAT
TGGCGCTTCCA -> GGCGCTTCCAG
CAGGTTGCTTT -> AGGTTGCTTTA
ACCCCAGGGCC -> CCCCAGGGCCG
GGCGCCATAGC -> GCGCCATAGCA
CTTCAGTTTAA -> TTCAGTTTAAC
CAGTTTAACAG -> AGTTTAACAGC
AGAGATGCGGC -> GAGATGCGGCC
TCAGGTGTGAT -> CAGGTGTGATA
TGCGAATGTGA -> GCGAATGTGAG
TTTCTGCTCGA -> TTCTGCTCGAT
CTTTACCACGG -> TTTACCACGGT
AGCTCCCTAAA -> GCTCCCTAAAC
GAAACGTCTTT -> AAACGTCTTTG
ATGTTAACCGC -> TGTTAACCGCG
ATTACGATATG -> TTACGATATGT
GAGTCGCAGAT -> AGTCGCAGATA
CAAGGTTCGAG -> AAGGTTCGAGT
CGAGGTGGCTA -> GAGGTGGCTAC
CTTTTCGTATC -> TTTTCGTATCT
AGATCCACCGT -> GATCCACCGTG
TATACGGGGCA -> ATACGGGGCAT
CTTAGTCCGGA -> TTAGTCCGGAG
TGCAGATTCGG -> GCAGATTCGGT
TTGTACGGTTA -> TGTACGGTTAT
CGCTCGAGTGA -> GCTCGAGTGAA
GACCGGGCCCT -> ACCGGGCCCTG
CGCGAACTGGA -> GCGAACTGGAG
GAATGTGAGTC -> AATGTGAGTCG
TGTTGTACGGT -> GTTGTACGGTT
GCAAATTTGAG -> CAAATTTGAGG
GCATCAGGTTG -> CATCAGGTTGC
CAATTACCCAC -> AATTACCCACT
CCACGGTATGT -> CACGGTATGTA
GACAACCTCAG -> ACAACCTCAGA
TCCGGAGACGC -> CCGGAGACGCG
GCATGGCGTTG -> CATGGCGTTGT
TGTTTCTGCTC -> GTTTCTGCTCG
GGTAAAGAACT -> GTAAAGAACTA
CCGAGCCATTA -> CGAGCCATTAT
TATTCGAAGAC -> ATTCGAAGACA
AGCATTCGTCG -> GCATTCGTCGA
ACAGTGCCGCG -> CAGTGCCGCGA
TCGCTAGCCCA -> CGCTAGCCCAA
TTATACGGGGC -> TATACGGGGCA
TGAAACGCTCA -> GAAACGCTCAG
TCGAGAGATGC -> CGAGAGATGCG
CTTGGCAAGGA -> TTGGCAAGGAC
GGGGACTACCG -> GGGACTACCGG
CCAGCAGTATA -> CAGCAGTATAA
GGAGAGGTAGC -> GAGAGGTAGCC
TTCAGTTTAAC -> TCAGTTTAACA
ATAAATCCGAG -> TAAATCCGAGC
AATACGAAGTA -> ATACGAAGTAA
GGCGTGTCTTT -> GCGTGTCTTTC
ACACATCGGCA -> CACATCGGCAT
GCCCTGAAGTT -> CCCTGAAGTTG
ACAATATGTAG -> CAATATGTAGA
ACAAGTAGGTT -> CAAGTAGGTTG
GTGTAGGCCCA -> TGTAGGCCCAG
GACTTCTGCCA -> ACTTCTGCCAG
AGCTCTCCTCT -> GCTCTCCTCTC
TGCTTTACCAC -> GCTTTACCACG
AGAACGTTGTG -> GAACGTTGTGC
CGAGGCAAATT -> GAGGCAAATTT
TGCGGCCTTGA -> GCGGCCTTGAT
CTGTCCGTGAT -> TGTCCGTGATT
AGTATGTCAGT -> GTATGTCAGTA
CCTTAGTCCGG -> CTTAGTCCGGA
TGGACGGCGCC -> GGACGGCGCCA
GCGCATTCCAC -> CGCATTCCACC
TTCGACCGGGC -> TCGACCGGGCC
GTAACATGCAG -> TAACATGCAGA
CGTTATATGAG -> GTTATATGAGT
CGCGAGCTCTA -> GCGAGCTCTAT
TCATGACTTGT -> CATGACTTGTG
AGCGCGGACTT -> GCGCGGACTTC
TGACTTGTGGG -> GACTTGTGGGA
AACTAGAGAAC -> ACTAGAGAACG
TAGGATATACA -> AGGATATACAC
TGATTCTCGAT -> GATTCTCGATT
CTCGGGCTTGC -> TCGGGCTTGCA
CGGACTTCTGC -> GGACTTCTGCC
GTACGTCGCTC -> TACGTCGCTCA
TTGTACTTGTC -> TGTACTTGTCT
GTCTTTGTTGC -> TCTTTGTTGCC
AGTTTAACAGC -> GTTTAACAGCG
ATGAGATCCAC -> TGAGATCCACC
TGAGATCCACC -> GAGATCCACCG
AATATGTAGAC -> ATATGTAGACC
ACGAGTGTCCG -> CGAGTGTCCGT
AACTACTAGAC -> ACTACTAGACT
TTCGAAGACAC -> TCGAAGACACT
TGGATTGACTA -> GGATTGACTAC
GGTATGTAATT -> GTATGTAATTC
GAGGCGTTTGA -> AGGCGTTTGAT
GGCGCTTAGTA -> GCGCTTAGTAG
TGATTCTTCGC -> GATTCTTCGCA
TTTTCGTATCT -> TTTCGTATCTC
AGTCGAGGTGG -> GTCGAGGTGGC
TGTTAGCCCCG -> GTTAGCCCCGC
AGGATTAATAT -> GGATTAATATT
CATCCCGCGCA -> ATCCCGCGCAT
CGGGCTGAGGA -> GGGCTGAGGAT
AAGGATCTTCG -> AGGATCTTCGG
GTATAAACCTA -> TATAAACCTAC
CATCGACATTG -> ATCGACATTGA
GTTTCTGCTCG -> TTTCTGCTCGA
TCCTGTCAAGG -> CCTGTCAAGGT
ACGACCGCGGA -> CGACCGCGGAC
TGAGGATTAAT -> GAGGATTAATA
CATCACATTAT -> ATCACATTATG
TACTAGACTCA -> ACTAGACTCAT
TGGACTTAACC -> GGACTTAACCT
GTAAATACGAA -> TAAATACGAAG
AGATAGAAATT -> GATAGAAATTT
CCTTTAACTGC -> CTTTAACTGCG
CTTGTAAATAC -> TTGTAAATACG
CGTAGACGCGC -> GTAGACGCGCG
ACCGAGTTCTC -> CCGAGTTCTCC
CGAGCCATTAT -> GAGCCATTATT
CTCAGGTGTGA -> TCAGGTGTGAT
AGTGTCCGTTC -> GTGTCCGTTCG
AACGTTGCGAA -> ACGTTGCGAAT
AGTTTTACGTG -> GTTTTACGTGT
GGTGGACGGCG -> GTGGACGGCGC
GTTCTAGTGAT -> TTCTAGTGATT
TCATCCGCTCC -> CATCCGCTCCC
ATAGATGGTAG -> TAGATGGTAGT
CACCCGAAAGC -> ACCCGAAAGCC
TTGATGGAACG -> TGATGGAACGT
CACAAGTAGGT -> ACAAGTAGGTT
AGCCCAATTGA -> GCCCAATTGAC
AGGTTGTTTTA -> GGTTGTTTTAT
GAGCTCTATAT -> AGCTCTATATG
AACTATTTAAT -> ACTATTTAATT
TCACATTATGG -> CACATTATGGG
CCCACCCAGGC -> CCACCCAGGCG
ATCGGCTGTCC -> TCGGCTGTCCG
ACTTAGAACTC -> CTTAGAACTCA
GTAGGTTGTTT -> TAGGTTGTTTT
TCGGGTGGACG -> CGGGTGGACGG
GTAGACTGTTC -> TAGACTGTTCG
TTTATCCCACC -> TTATCCCACCC
CTAATAACACC -> TAATAACACCA
CCTACAAAGGC -> CTACAAAGGCG
TAGGTTGTTTT -> AGGTTGTTTTA
TGCCAGGTGCT -> GCCAGGTGCTC
AGTGTCCGGAT -> GTGTCCGGATC
CCGGACTATGT -> CGGACTATGTT
ATCACATTATG -> TCACATTATGG
TAGTTGACACC -> AGTTGACACCA
ACTCAGGTGTG -> CTCAGGTGTGA
AAGCATCACAT -> AGCATCACATT
GGAGTTTCATA -> GAGTTTCATAA
CTCATCATGAC -> TCATCATGACT
TCCTAGTTGAC -> CCTAGTTGACA
CAGATATGTAA -> AGATATGTAAC
CTCGTAACATG -> TCGTAACATGC
CACATTATGGG -> ACATTATGGGC
CGTCGCTCATC -> GTCGCTCATCA
CGGCGCCATAG -> GGCGCCATAGC
GGCAGCATCTA -> GCAGCATCTAT
AACGTTGTGCC -> ACGTTGTGCCA
AGTAGAGTAGC -> GTAGAGTAGCC
TACTCGTGGTT -> ACTCGTGGTTA
TTCACCTTAGT -> TCACCTTAGTC
CTCCCTAAACG -> TCCCTAAACGG
CAAATGCCCAT -> AAATGCCCATC
CACTAATAACA -> ACTAATAACAC
ATTCTCGATTG -> TTCTCGATTGG
TTAACATCCGA -> TAACATCCGAC
AAAGAAGCTGC -> AAGAAGCTGCG
CAAGATAGAAA -> AAGATAGAAAT
CTTCGTTAGGC -> TTCGTTAGGCG
CCCGCGCATTC -> CCGCGCATTCC
TGTCACGCCGA -> GTCACGCCGAG
CCAGTGTCCGG -> CAGTGTCCGGA
GCGCTTCCAGC -> CGCTTCCAGCA
CGTTGGGAGTT -> GTTGGGAGTTT
TCCTGTTCGTT -> CCTGTTCGTTA
ATCGGCATCAG -> TCGGCATCAGG
GGTTAACCTTT -> GTTAACCTTTA
CGCGAGGCAAA -> GCGAGGCAAAT
TCATTTCCCAC -> CATTTCCCACC
AATTGACGAGT -> ATTGACGAGTG
GTTTCCCGTTT -> TTTCCCGTTTT
GAGAGCTCCCT -> AGAGCTCCCTA
GGGTGGACGGC -> GGTGGACGGCG
ACTGTTCGGGT -> CTGTTCGGGTG
TGATCATGTAT -> GATCATGTATT
GACTTAACCTT -> ACTTAACCTTG
CTTTCCCTTCG -> TTTCCCTTCGT
GTCTTGGCATT -> TCTTGGCATTA
GGCTAAGGCTG -> GCTAAGGCTGC
GCTGCTCATCG -> CTGCTCATCGC
TTGGACTTAAC -> TGGACTTAACC
GGGAGTCTCGT -> GGAGTCTCGTA
GAACTCAACAG -> AACTCAACAGA
ACCGTGGTGTA -> CCGTGGTGTAG
ATATGAGTATG -> TATGAGTATGT
TTGCCGGTTTG -> TGCCGGTTTGC
TTATTACGATA -> TATTACGATAT
GTGAAACGCTC -> TGAAACGCTCA
CGGTCCTCCCC -> GGTCCTCCCCC
CATGTTCTAGT -> ATGTTCTAGTG
CGGTTATTACG -> GGTTATTACGA
CCACCGTGGTG -> CACCGTGGTGT
AGTAGCCTCAC -> GTAGCCTCACA
AAAGAGTTGGT -> AAGAGTTGGTT
ATTCGAAGACA -> TTCGAAGACAC
TCAGTACCGAG -> CAGTACCGAGT
TGGAACTTAGA -> GGAACTTAGAA
CGCAGTGCCCT -> GCAGTGCCCTG
AGTATTTTGTT -> GTATTTTGTTA
TCACCTTTCGC -> CACCTTTCGCT
TCGGGCTGAGG -> CGGGCTGAGGA
GACCGAGCCAT -> ACCGAGCCATT
AAGCCTACAAA -> AGCCTACAAAG
GTTGTGCATCT -> TTGTGCATCTA
TTTCCCTTCGT -> TTCCCTTCGTT
TCCCTAAACGG -> CCCTAAACGGG
GATTAATATTG -> ATTAATATTGG
TAGTCGAGGTG -> AGTCGAGGTGG
ACCTCAGATGT -> CCTCAGATGTG
CGGACGCCTTC -> GGACGCCTTCA
TTACTTGGCAA -> TACTTGGCAAG
CCTTTCGCTAG -> CTTTCGCTAGC
TGTAACACCCG -> GTAACACCCGA
AGTAACCGGAC -> GTAACCGGACT
CGTGATTCTTC -> GTGATTCTTCG
CATCCAACGAT -> ATCCAACGATT
GAGTAGCCTCA -> AGTAGCCTCAC
CCTGTCTTCGA -> CTGTCTTCGAG
CAAAGAAGCTG -> AAAGAAGCTGC
GTGAGAGCTCC -> TGAGAGCTCCC
CTTTGGTCAGT -> TTTGGTCAGTC
GCGGACGCCTT -> CGGACGCCTTC
GACCGGTTGTA -> ACCGGTTGTAC
AGCGGCGGTTG -> GCGGCGGTTGT
TGTATATCTGA -> GTATATCTGAT
TATTTTGTTAC -> ATTTTGTTACT
TGCCAGTCATG -> GCCAGTCATGA
TAACAGCGTTC -> AACAGCGTTCT
TATCTCAATGG -> ATCTCAATGGC
TCTCAATGGCA -> CTCAATGGCAT
GGTTAAACGAC -> GTTAAACGACC
GTTCTCCAGCG -> TTCTCCAGCGG
CCGTAGACGCG -> CGTAGACGCGC
AGACTCATCGA -> GACTCATCGAT
CTCCCTGTCAC -> TCCCTGTCACG
ACTACTAGACT -> CTACTAGACTC
CTAGACTCATC -> TAGACTCATCG
TTGGTAAAGCC -> TGGTAAAGCCT
CACCCAGGCGT -> ACCCAGGCGTG
ATTGACGAGTG -> TTGACGAGTGT
AACACCCGAAA -> ACACCCGAAAG
TTAATATTGGA -> TAATATTGGAC
AGCACATCCCG -> GCACATCCCGC
TACCACGGTAT -> ACCACGGTATG
GGCCTTGATCC -> GCCTTGATCCC
GTTGTTTTATC -> TTGTTTTATCC
TAGTGGAAAGT -> AGTGGAAAGTA
CGACCGCGGAC -> GACCGCGGACG
CCCAGGGCCGA -> CCAGGGCCGAG
AGTGCAACCAT -> GTGCAACCATA
CGAATTCCCCG -> GAATTCCCCGG
ATAAAAGGATC -> TAAAAGGATCT
CACTACTTGTA -> ACTACTTGTAA
ATTCGTCGAGT -> TTCGTCGAGTC
AGGCAAATTTG -> GGCAAATTTGA
TTCGCAGTGCC -> TCGCAGTGCCC
AGTGAATTTCT -> GTGAATTTCTG
GTTGTGCCAGT -> TTGTGCCAGTG
TTTTATCCCAC -> TTTATCCCACC
CTTTCGCTAGC -> TTTCGCTAGCC
GTATGAGATCC -> TATGAGATCCA
GCGGACTTCTG -> CGGACTTCTGC
GTCCGTGATTC -> TCCGTGATTCT
TTGGAACTTAG -> TGGAACTTAGA
GTCCTCCCCCA -> TCCTCCCCCAG
ATCCCACCCAG -> TCCCACCCAGG
ACTTTTTCGAC -> CTTTTTCGACC
TACACGAAAAC -> ACACGAAAACG
CGCCATAGCAC -> GCCATAGCACA
TAGTAGACTGT -> AGTAGACTGTT
AAGGTAAAGAA -> AGGTAAAGAAC
TGGGCGAGGAC -> GGGCGAGGACC
AGCATCACATT -> GCATCACATTA
GAGCATTCGTC -> AGCATTCGTCG
TTGGGAGTTTC -> TGGGAGTTTCA
GATGGTAGTGG -> ATGGTAGTGGA
GCTCCCTGTCA -> CTCCCTGTCAC
AATTTATACGG -> ATTTATACGGG
TAAGGCTGCTC -> AAGGCTGCTCA
ATCGCGAACCA -> TCGCGAACCAG
TTAGAAGGTAA -> TAGAAGGTAAA
AGATGTGGATT -> GATGTGGATTG
CCACCCTGTTT -> CACCCTGTTTC
ACAGCGTTCTT -> CAGCGTTCTTA
GGTTGTTTTAT -> GTTGTTTTATC
TTTACGTGTCT -> TTACGTGTCTG
CACCCGAACTA -> ACCCGAACTAG
GGCTGTCCGTG -> GCTGTCCGTGA
TAATTACTTGG -> AATTACTTGGC
GTCTTCGAGAG -> TCTTCGAGAGA
GATCATGTATT -> ATCATGTATTC
CTTAGAAGGTA -> TTAGAAGGTAA
TCGGCATCAGG -> CGGCATCAGGT
CGAGTAGAGTA -> GAGTAGAGTAG
AAGATAGAAAT -> AGATAGAAATT
TATGCCCCACA -> ATGCCCCACAA
TCTATGCCCCA -> CTATGCCCCAC
ATGTATTCGAA -> TGTATTCGAAG
AGGCGCGACAA -> GGCGCGACAAC
TAGCCTCACAC -> AGCCTCACACT
GTCTAGTGAAA -> TCTAGTGAAAC
TCAGGTTGCTT -> CAGGTTGCTTT
CAGCAGTATAA -> AGCAGTATAAA
GATAGGATATA -> ATAGGATATAC
AGTGCCCTGTC -> GTGCCCTGTCT
GTAGGATTAGG -> TAGGATTAGGG
CCTGCATTCGA -> CTGCATTCGAG
TGGAGGAACAC -> GGAGGAACACG
GGGGCGCCTAC -> GGGCGCCTACT
TCGAAGACACT -> CGAAGACACTG
CGACAACCTCA -> GACAACCTCAG
TTTGTTGCCGG -> TTGTTGCCGGT
GCGAGGCAAAT -> CGAGGCAAATT
GGATTAGGGGC -> GATTAGGGGCC
CGTATCTCAAT -> GTATCTCAATG
GCCTGTCTTCG -> CCTGTCTTCGA
TGTCCTGCATT -> GTCCTGCATTC
CATAGCACATC -> ATAGCACATCC
CGCTCATCATG -> GCTCATCATGA
TACTAGTTTTA -> ACTAGTTTTAC
CTAGTGAAACG -> TAGTGAAACGC
TTTAGTTTTCA -> TTAGTTTTCAG
TACGTCGCTCA -> ACGTCGCTCAT
TTCACCTTTTC -> TCACCTTTTCG
AAAGCCTACAA -> AAGCCTACAAA
ATAATCTTCAG -> TAATCTTCAGT
CGGACTATGTT -> GGACTATGTTG
GCCCATCCAAC -> CCCATCCAACG
CAGTATAAACC -> AGTATAAACCT
GGCATCAGGTT -> GCATCAGGTTG
TCAGTCCGTAG -> CAGTCCGTAGA
CCTACACAACC -> CTACACAACCG
CAACCATATCC -> AACCATATCCC
GCCAGTCATGA -> CCAGTCATGAG
AATCTTCAGTT -> ATCTTCAGTTT
ACAAAGAAGCT -> CAAAGAAGCTG
TTCGGTCCTCC -> TCGGTCCTCCC
ATATAAGTATT -> TATAAGTATTT
CCCTCTTCACC -> CCTCTTCACCT
CCTCCGCCCGA -> CTCCGCCCGAA
CTGTTTCCCGT -> TGTTTCCCGTT
TCACGCCGAGC -> CACGCCGAGCA
GCCGAGCACTG -> CCGAGCACTGC
CCAATTGACGA -> CAATTGACGAG
CGCGAAGCATC -> GCGAAGCATCA
GATTCTTCGCA -> ATTCTTCGCAG
TAGTGAAACGC -> AGTGAAACGCT
TCGAGGTGGCT -> CGAGGTGGCTA
TATTACGATAT -> ATTACGATATG
AAATTTGAGGC -> AATTTGAGGCG
CTACTTGTAAA -> TACTTGTAAAT
CATTCGAGCTC -> ATTCGAGCTCT
CATTCCACCCG -> ATTCCACCCGA
TTGTCTAGTGA -> TGTCTAGTGAA
CTACAAAGGCG -> TACAAAGGCGC
ATCTATGCCCC -> TCTATGCCCCA
GAGGGGCGCCT -> AGGGGCGCCTA
AATTTCTGCAT -> ATTTCTGCATG
AATTTGAGGCG -> ATTTGAGGCGT
CGTGATCATGT -> GTGATCATGTA
ATGGCATCGGC -> TGGCATCGGCT
GACTATGTTGT -> ACTATGTTGTA
GGTTGTACTTG -> GTTGTACTTGT
TGAGGGGCGCC -> GAGGGGCGCCT
ACCTACACAAC -> CCTACACAACC
TCGTTATATGA -> CGTTATATGAG
AGATGGTAGTG -> GATGGTAGTGG
TCGCAGATATG -> CGCAGATATGT
TACGAAGTAAC -> ACGAAGTAACC
TAGAAATTTAT -> AGAAATTTATA
CTCATCGCGAA -> TCATCGCGAAC
ACGGTTATTAC -> CGGTTATTACG
ATACGCTCGGG -> TACGCTCGGGC
TCGTTAGGCGA -> CGTTAGGCGAT
CATCGGCTGTC -> ATCGGCTGTCC
CTCTATATGGG -> TCTATATGGGG
CTTGCAACCCC -> TTGCAACCCCA
TGAGTATGTCA -> GAGTATGTCAG
CCTGTCACGCC -> CTGTCACGCCG
CACCTTAGTCC -> ACCTTAGTCCG
ACGTCGGCGCT -> CGTCGGCGCTT
CACTGCCAGTC -> ACTGCCAGTCA
GCATTCCACCC -> CATTCCACCCG
CAACCGCGAAG -> AACCGCGAAGC
GATTAGGGGCC -> ATTAGGGGCCA
TAATTCGGTTA -> AATTCGGTTAA
TTTCGACCGGG -> TTCGACCGGGC
ATAAGTGGAAA -> TAAGTGGAAAG
AGGCGTGTCTT -> GGCGTGTCTTT
GAGGCAAATTT -> AGGCAAATTTG
AGGTGTGATAT -> GGTGTGATATA
AATTACCCACT -> ATTACCCACTT
CGGGTGGACGG -> GGGTGGACGGC
AGTTGGCAGCA -> GTTGGCAGCAT
CTGTTCGTTAT -> TGTTCGTTATA
ATGTCAGTACC -> TGTCAGTACCG
GTATCTCAATG -> TATCTCAATGG
TAACCGCGAGC -> AACCGCGAGCT
AGGAACAGTGC -> GGAACAGTGCC
TAGGGGCCATG -> AGGGGCCATGT
CGGAGACGCGA -> GGAGACGCGAG
CTTGGCATTAG -> TTGGCATTAGT
GTTGCCGGTTT -> TTGCCGGTTTG
GCGAGGACCGA -> CGAGGACCGAG
GTGGTTAAACG -> TGGTTAAACGA
GGTTTGCTACT -> GTTTGCTACTA
ATTGGTAAAGC -> TTGGTAAAGCC
GATATACACGA -> ATATACACGAA
TTCCCACCCTG -> TCCCACCCTGT
CTCGTGGTTAA -> TCGTGGTTAAA
GTAAAGCCTAC -> TAAAGCCTACA
AGGAACACGGG -> GGAACACGGGG
GCGGTTGTTAG -> CGGTTGTTAGC
CCTGTCTGACT -> CTGTCTGACTT
GGGGCCATGTT -> GGGCCATGTTC
GTGATTCTTCG -> TGATTCTTCGC
GACACCAGTCA -> ACACCAGTCAT
ACGAAGTAACC -> CGAAGTAACCG
CCTAGTTGACA -> CTAGTTGACAC
GACGAGTGTCC -> ACGAGTGTCCG
CGTTCGTTTGT -> GTTCGTTTGTC
CCTTCGTTAGG -> CTTCGTTAGGC
AACATGCAGAT -> ACATGCAGATT
ATGTAATTCGG -> TGTAATTCGGT
TATGTTGTACG -> ATGTTGTACGG
TCTTGGAGGAA -> CTTGGAGGAAC
GATTCTTTCAC -> ATTCTTTCACC
ATGTTCTAGTG -> TGTTCTAGTGA
TTCGGATTTCG -> TCGGATTTCGT
GCATCGGCTGT -> CATCGGCTGTC
GTTATTACGAT -> TTATTACGATA
TCATCGATAAA -> CATCGATAAAT
GACTTAGAACT -> ACTTAGAACTC
AACCCCAGGGC -> ACCCCAGGGCC
AGTGGCGCTTC -> GTGGCGCTTCC
CTGTCAAGGTT -> TGTCAAGGTTC
TAGAGTAGCCT -> AGAGTAGCCTC
CCACAAGTAGG -> CACAAGTAGGT
CGGGCTTGCAA -> GGGCTTGCAAC
GAGTCTCGTAA -> AGTCTCGTAAC
TCAAGGTTCGA -> CAAGGTTCGAG
CCAGTCATGAG -> CAGTCATGAGG
GCGATGTACTC -> CGATGTACTCA
GCCGGTTTGCT -> CCGGTTTGCTA
TTGAAATCTTG -> TGAAATCTTGG
TATAATCTTCA -> ATAATCTTCAG
TCTCCTCTCCT -> CTCCTCTCCTG
TCCCCCAGGAA -> CCCCCAGGAAC
GGTTATTACGA -> GTTATTACGAT
GCCGACATGTT -> CCGACATGTTG
AGTAGACTGTT -> GTAGACTGTTC
AAAACGGGAAC -> AAACGGGAACA
TCGAGTCTACT -> CGAGTCTACTG
TTCCCGTTTTA -> TCCCGTTTTAG
TATAAACCTAC -> ATAAACCTACA
ATCCGACTTCA -> TCCGACTTCAA
TCGACCGGGCC -> CGACCGGGCCC
GCCATTATTAA -> CCATTATTAAT
CTTAACCTTGG -> TTAACCTTGGC
GGTAAAGCCTA -> GTAAAGCCTAC
CACATCCCGCG -> ACATCCCGCGC
ACGTCGCTCAT -> CGTCGCTCATC
ACTGGAGAGGT -> CTGGAGAGGTA
CGAGCTCTCCT -> GAGCTCTCCTC
GTTCTTACTCG -> TTCTTACTCGT
GTAGAGTAGCC -> TAGAGTAGCCT
TTTGGTCAGTC -> TTGGTCAGTCC
TTGGGGTATGA -> TGGGGTATGAT
CACATCGGCAT -> ACATCGGCATC
TGCCCATCCAA -> GCCCATCCAAC
TTCGTATCTCA -> TCGTATCTCAA
AATTCGGTTAA -> ATTCGGTTAAC
TTGATCCCAGT -> TGATCCCAGTG
TTGTAAATACG -> TGTAAATACGA
GGGGCATCGGG -> GGGCATCGGGC
TGTTAACCGCG -> GTTAACCGCGA
TGGTTAAACGA -> GGTTAAACGAC
GGCTACGTACA -> GCTACGTACAC
TTATTAATAAT -> TATTAATAATA
GAGTTTCATAA -> AGTTTCATAAG
GCAACCATATC -> CAACCATATCC
CCGCGGACGCC -> CGCGGACGCCT
GTGGCTACGTA -> TGGCTACGTAC
GCGAACTGGAG -> CGAACTGGAGA
GGCAAGGACCT -> GCAAGGACCTA
ATATGTCCTGC -> TATGTCCTGCA
CTATTTAATTA -> TATTTAATTAC
ATCAGGTTGCT -> TCAGGTTGCTT
GGGCTAAGGCT -> GGCTAAGGCTG
TAGAACTCAAC -> AGAACTCAACA
CCGAGTTCTCC -> CGAGTTCTCCA
CATCATGACTT -> ATCATGACTTG
GCCAGTGGATT -> CCAGTGGATTG
TCGTACGTCGC -> CGTACGTCGCT
TCCAACGATTC -> CCAACGATTCG
GCTCGATAGGA -> CTCGATAGGAT
GACGATTGTTA -> ACGATTGTTAC
ACATGCAGATT -> CATGCAGATTC
GTGATCATGTA -> TGATCATGTAT
GACATGTTGAA -> ACATGTTGAAA
GGACTATGTTG -> GACTATGTTGT
GTACTCATTTC -> TACTCATTTCC
AAAGAACTACT -> AAGAACTACTA
TCCCGTTTTAG -> CCCGTTTTAGT
CCCTAAACGGG -> CCTAAACGGGA
CGTACACTACT -> GTACACTACTT
CGGTTGTACTT -> GGTTGTACTTG
GGCGCCTACTT -> GCGCCTACTTG
AGACGTGGATG -> GACGTGGATGT
ATGGGCTCCTC -> TGGGCTCCTCC
TTCGTCGAGTC -> TCGTCGAGTCT
CTCAATGGCAT -> TCAATGGCATC
ACGGGGCTAAG -> CGGGGCTAAGG
TACGCTCGGGC -> ACGCTCGGGCT
GTAACACCCGA -> TAACACCCGAA
TCTCGATTGGA -> CTCGATTGGAA
TGTCTTAACAT -> GTCTTAACATC
GAACTTAGAAG -> AACTTAGAAGG
TTGACAAAGAA -> TGACAAAGAAG
CCCCAGGAACA -> CCCAGGAACAG
CATAGATGGTA -> ATAGATGGTAG
TTCGCTAGCCC -> TCGCTAGCCCA
TAAGTATTTTG -> AAGTATTTTGT
GCGAATAAATC -> CGAATAAATCC
TGTCTAGTGAA -> GTCTAGTGAAA
ACGATTGTTAC -> CGATTGTTACA
TTCAATTACCC -> TCAATTACCCA
CCACCCGAACT -> CACCCGAACTA
AAGGCTGCTCA -> AGGCTGCTCAT
CCCCACAAGTA -> CCCACAAGTAG
CACTGGGGACT -> ACTGGGGACTA
TCCTCCGCCCG -> CCTCCGCCCGA
GTTCGAGTAGA -> TTCGAGTAGAG
TTACCCACTTT -> TACCCACTTTT
CCTACGGTGTA -> CTACGGTGTAT
ACGTTGTGCCA -> CGTTGTGCCAG
CAGCGTTCTTA -> AGCGTTCTTAC
ATAAACCTACA -> TAAACCTACAC
TTCTTCGCAGT -> TCTTCGCAGTG
ACGGTATGTAA -> CGGTATGTAAT
GCCCTGTCTGA -> CCCTGTCTGAC
ACTAGAGAACG -> CTAGAGAACGT
TCTTCGAGAGA -> CTTCGAGAGAT
CCCGAAACGTC -> CCGAAACGTCT
ATGAGTATGTC -> TGAGTATGTCA
TAGACGCGCGA -> AGACGCGCGAA
TTAGTAGACTG -> TAGTAGACTGT
AGTGATTAGTG -> GTGATTAGTGC
TCACACTAATA -> CACACTAATAA
CCAGTGGATTG -> CAGTGGATTGT
TACTCATTTCC -> ACTCATTTCCC
ACTATGTTGTA -> CTATGTTGTAC
GCCCTGTGACT -> CCCTGTGACTC
AGGTGCTCCTG -> GGTGCTCCTGT
ATGTTGTACGG -> TGTTGTACGGT
CAGTCCGTAGA -> AGTCCGTAGAC
TAGCCCCGCGA -> AGCCCCGCGAA
CGGTGTATGAG -> GGTGTATGAGA
CAAATTTGAGG -> AAATTTGAGGC
TTGAGGCGTTT -> TGAGGCGTTTG
GCGAGCTCTAT -> CGAGCTCTATA
TCGAGCTCTCC -> CGAGCTCTCCT
GTTATATGAGT -> TTATATGAGTA
TTTTCACCTTT -> TTTCACCTTTT
ATGTATATCTG -> TGTATATCTGA
CCCTGAAGTTG -> CCTGAAGTTGG
CGAAGACACTG -> GAAGACACTGG
GGCCCTGAAGT -> GCCCTGAAGTT
TGTAGGCCCAG -> GTAGGCCCAGT
TATGGGCTCCT -> ATGGGCTCCTC
ATCTGATTAGA -> TCTGATTAGAT
TGTTGCCGGTT -> GTTGCCGGTTT
ACTTAGAAGGT -> CTTAGAAGGTA
GACGGCGCCAT -> ACGGCGCCATA
TTGTTACAATA -> TGTTACAATAT
TCTTAACATCC -> CTTAACATCCG
GTTTAGTTTTC -> TTTAGTTTTCA
GACGCCTTCAG -> ACGCCTTCAGG
ACCTTTAACTG -> CCTTTAACTGC
GTGATTAGTGC -> TGATTAGTGCA
GAAACGCTCAG -> AAACGCTCAGC
TGGCTTTGGTC -> GGCTTTGGTCA
AGCCATACGCT -> GCCATACGCTC
CATCCGACTTC -> ATCCGACTTCA
ACTTGGCAAGG -> CTTGGCAAGGA
GGACTTAACCT -> GACTTAACCTT
GTCGGCGCTTA -> TCGGCGCTTAG
AACGTCTTTGT -> ACGTCTTTGTT
CAGTGGATTGT -> AGTGGATTGTG
GCCCCGCGAAT -> CCCCGCGAATT
CATGGCGTTGT -> ATGGCGTTGTG
GTGGAAAGTAG -> TGGAAAGTAGG
CCTCCCCCAGG -> CTCCCCCAGGA
ACCTACGGTGT -> CCTACGGTGTA
CCTGAAGTTGG -> CTGAAGTTGGC
TATGTCAGTAC -> ATGTCAGTACC
GCTACTAGTTT -> CTACTAGTTTT
CTGCCAGTCAT -> TGCCAGTCATG
CCCGTTTTAGT -> CCGTTTTAGTA
AGTATAAACCT -> GTATAAACCTA
TTCGAGTAGAG -> TCGAGTAGAGT
TCGCAGTGCCC -> CGCAGTGCCCT
CGAGCGCGGAC -> GAGCGCGGACT
TCGACATTGAC -> CGACATTGACA
TTACTCGTGGT -> TACTCGTGGTT
TTTGTTACTTG -> TTGTTACTTGA
CCGCGAATTCC -> CGCGAATTCCC
ATCGATAAATC -> TCGATAAATCT
AAAAGGATCTT -> AAAGGATCTTC
TGGAGAGGTAG -> GGAGAGGTAGC
TCACCTTAGTC -> CACCTTAGTCC
GTAGACGCGCG -> TAGACGCGCGA
TGTTCGTTATA -> GTTCGTTATAT
ACCCGAACTAG -> CCCGAACTAGA
GGCATCGGGCT -> GCATCGGGCTG
CATTAGTCGAG -> ATTAGTCGAGG
GAGTAGAGTAG -> AGTAGAGTAGC
CCGCGCATTCC -> CGCGCATTCCA
TTTTTCGACCG -> TTTTCGACCGG
GAGTTCTCCAG -> AGTTCTCCAGC
ACTGGGCGAGG -> CTGGGCGAGGA
CGAGCATTCGT -> GAGCATTCGTC
CTCATCGATAA -> TCATCGATAAA
TGTCCGTGATT -> GTCCGTGATTC
ATTTAATTACT -> TTTAATTACTT
GTCTACTGGGC -> TCTACTGGGCG
CTCACACTAAT -> TCACACTAATA
GCTTGCAACCC -> CTTGCAACCCC
TACAAGATAGA -> ACAAGATAGAA
CTTTTTCGACC -> TTTTTCGACCG
GGCGTTTGATG -> GCGTTTGATGG
CGCGCATTCCA -> GCGCATTCCAC
GGAACAGTGCC -> GAACAGTGCCG
TTCTCCAGCGG -> TCTCCAGCGGC
GGGGCTAAGGC -> GGGCTAAGGCT
CCATAGCACAT -> CATAGCACATC
TGTATTCGAAG -> GTATTCGAAGA
CTCCAGCGGCG -> TCCAGCGGCGG
CTTGGGGTATG -> TTGGGGTATGA
CCAGCGGCGGT -> CAGCGGCGGTT
TAAAAGGATCT -> AAAAGGATCTT
CTAGTTGACAC -> TAGTTGACACC
ACGTGTCTGCA -> CGTGTCTGCAG
AAACCTACACA -> AACCTACACAA
ATATGTAACAC -> TATGTAACACC
TTTCGTATCTC -> TTCGTATCTCA
TCGCTCATCAT -> CGCTCATCATG
GAGATCCACCG -> AGATCCACCGT
CTAGTTTTACG -> TAGTTTTACGT
TCTTCACCTTA -> CTTCACCTTAG
TCCAGCGGCGG -> CCAGCGGCGGT
TGCTCCTGTCA -> GCTCCTGTCAA
GCGACAACCTC -> CGACAACCTCA
ATCATGTATTC -> TCATGTATTCG
CGAGGACCGAG -> GAGGACCGAGC
CGTCGAGTCTA -> GTCGAGTCTAC
TGAGTCGCAGA -> GAGTCGCAGAT
ATTAATATTGG -> TTAATATTGGA
TCGATTGGAAC -> CGATTGGAACT
AACCGGACTAT -> ACCGGACTATG
GAAAGAGTTGG -> AAAGAGTTGGT
AATAAATCCGA -> ATAAATCCGAG
CTTCCAGCAGT -> TTCCAGCAGTA
GTAATTCGGTT -> TAATTCGGTTA
CTACTAGTTTT -> TACTAGTTTTA
AGGATCTTCGG -> GGATCTTCGGA
TAAAGAACTAC -> AAAGAACTACT
GACTCAGGTGT -> ACTCAGGTGTG
TCGTGGTTAAA -> CGTGGTTAAAC
TTACCACGGTA -> TACCACGGTAT
TGATATAAGTA -> GATATAAGTAT
GTGTATGAGAT -> TGTATGAGATC
CTATGTTGTAC -> TATGTTGTACG
ACCGGACTATG -> CCGGACTATGT
AGGATATACAC -> GGATATACACG
ATGCGGCCTTG -> TGCGGCCTTGA
GGCATTAGTCG -> GCATTAGTCGA
GAAGTAACCGG -> AAGTAACCGGA
ATGATTCTCGA -> TGATTCTCGAT
GATGTATATCT -> ATGTATATCTG
ACGAAAACGGG -> CGAAAACGGGA
AAGAACTACTA -> AGAACTACTAG
GACTACCGGAT -> ACTACCGGATG
GCCCCACAAGT -> CCCCACAAGTA
CTTCGGATTTC -> TTCGGATTTCG
AGGCGTTTGAT -> GGCGTTTGATG
CGCCGAGCACT -> GCCGAGCACTG
CACACTAATAA -> ACACTAATAAC
AAATCATCGAC -> AATCATCGACA
AGAAGCTGCGA -> GAAGCTGCGAA
ACCATATCCCT -> CCATATCCCTC
TCTAGTGAAAC -> CTAGTGAAACG
AACTCAACAGA -> ACTCAACAGAC
AGCCATTATTA -> GCCATTATTAA
TGTGACTCAGG -> GTGACTCAGGT
TGCCCCACAAG -> GCCCCACAAGT
CACCATTGGTA -> ACCATTGGTAA
AACCAGTACCC -> ACCAGTACCCA
CAGTCATGAGG -> AGTCATGAGGG
CGCATTCCACC -> GCATTCCACCC
ACGGTGTATGA -> CGGTGTATGAG
CCATTATTAAT -> CATTATTAATA
CCTTTTCGTAT -> CTTTTCGTATC
ATGTACTCATT -> TGTACTCATTT
CGCGGACTTCT -> GCGGACTTCTG
CTTGTGGGAGT -> TTGTGGGAGTC
TTAGGGGCCAT -> TAGGGGCCATG
GCAGATATGTA -> CAGATATGTAA
TACCCATGTTA -> ACCCATGTTAA
GGCAAATTTGA -> GCAAATTTGAG
CGGATTTCGTG -> GGATTTCGTGA
GGCGTTGTGCA -> GCGTTGTGCAT
ACTTCTGCCAG -> CTTCTGCCAGG
TCTGCTCGATA -> CTGCTCGATAG
CCTTGATCCCA -> CTTGATCCCAG
TCCGGATCGTA -> CCGGATCGTAC
CCGTGGTGTAG -> CGTGGTGTAGG
TCGATAGGATA -> CGATAGGATAT
TAAATCTGGCT -> AAATCTGGCTT
TTTGAGGCGTT -> TTGAGGCGTTT
GTGGCGCTTCC -> TGGCGCTTCCA
GTAAAGAACTA -> TAAAGAACTAC
TGGCGTTGTGC -> GGCGTTGTGCA
TGGCATTAGTC -> GGCATTAGTCG
CCCACCCTGTT -> CCACCCTGTTT
TAGACCGGTTG -> AGACCGGTTGT
TGCCCTGTCTG -> GCCCTGTCTGA
ACATAGATGGT -> CATAGATGGTA
CTACTGGGCGA -> TACTGGGCGAG
GCCCGAAACGT -> CCCGAAACGTC
AACCTACACAA -> ACCTACACAAC
TAGGCCCAGTG -> AGGCCCAGTGT
TTGATTAACAC -> TGATTAACACA
TACAAAGGCGC -> ACAAAGGCGCG
GGTGTGATATA -> GTGTGATATAA
TCTGCAGTCTT -> CTGCAGTCTTG
CGGTATGTAAT -> GGTATGTAATT
GTATGATTCTC -> TATGATTCTCG
AACAGCGTTCT -> ACAGCGTTCTT
ACCCGAAAGCC -> CCCGAAAGCCA
CTGTTCGGGTG -> TGTTCGGGTGG
GAACACGGGGC -> AACACGGGGCT
GATTCGGTCCT -> ATTCGGTCCTC
GCATTCGAGCT -> CATTCGAGCTC
TGTACGGTTAT -> GTACGGTTATT
GAGTGTCCGTT -> AGTGTCCGTTC
CCAGGGCCGAG -> CAGGGCCGAGC
CCGGAGACGCG -> CGGAGACGCGA
GCCTCACACTA -> CCTCACACTAA
CGACATTGACA -> GACATTGACAA
GAACTAGAGAA -> AACTAGAGAAC
CGTTGTGCCAG -> GTTGTGCCAGT
CTACAAGATAG -> TACAAGATAGA
TCCCACCCAGG -> CCCACCCAGGC
GCCGCGATCGT -> CCGCGATCGTG
CTGCTCGATAG -> TGCTCGATAGG
CCCAGGCGTGT -> CCAGGCGTGTC
TAACACCATTG -> AACACCATTGG
TTAACCTTGGC -> TAACCTTGGCA
TTGTTAGCCCC -> TGTTAGCCCCG
ATTCCACCCGA -> TTCCACCCGAA
ACCCATGTTAA -> CCCATGTTAAC
CAGCGGCGGTT -> AGCGGCGGTTG
GCGCCATAGCA -> CGCCATAGCAC
ACACAACCGCG -> CACAACCGCGA
GTCGCTCATCA -> TCGCTCATCAT
TGATCCCAGTG -> GATCCCAGTGG
TGTTTTATCCC -> GTTTTATCCCA
ATTCGGTTAAC -> TTCGGTTAACC
CTCATTTCCCA -> TCATTTCCCAC
GACTTGTGGGA -> ACTTGTGGGAG
AACGGGACGAT -> ACGGGACGATT
TTATCCCACCC -> TATCCCACCCA
GGCGCGACAAC -> GCGCGACAACC
TGCATCTATGC -> GCATCTATGCC
GTAGGCTCCTA -> TAGGCTCCTAG
GATATGTCCTG -> ATATGTCCTGC
ACTCGTGGTTA -> CTCGTGGTTAA
TTTAATTACTT -> TTAATTACTTG
CAGATGTGGAT -> AGATGTGGATT
CGCAGATATGT -> GCAGATATGTA
AGTTGGTTTTT -> GTTGGTTTTTT
CGACATGTTGA -> GACATGTTGAA
TAGGCGATGTA -> AGGCGATGTAC
GTCGAGTCTAC -> TCGAGTCTACT
AAAGCCATACG -> AAGCCATACGC
TCTGGCTTTGG -> CTGGCTTTGGT
CTGAGGATTAA -> TGAGGATTAAT
TTGACTACAAG -> TGACTACAAGA
TATATCTGATT -> ATATCTGATTA
TGAGGCGTTTG -> GAGGCGTTTGA
AAATGCCCATC -> AATGCCCATCC
GCGGCGGTTGT -> CGGCGGTTGTT
ATGGAACGTTG -> TGGAACGTTGC
GTGGAAAGAGT -> TGGAAAGAGTT
GATTCTCGATT -> ATTCTCGATTG
TAACCTTTAAC -> AACCTTTAACT
GTGAGTCGCAG -> TGAGTCGCAGA
TCGTTTGTCTT -> CGTTTGTCTTA
ACCTTTCGCTA -> CCTTTCGCTAG
GCGCGGACTTC -> CGCGGACTTCT
GCTCATCATGA -> CTCATCATGAC
ATTGGACTTAA -> TTGGACTTAAC
CATTATTAATA -> ATTATTAATAA
GGTAGTGGAAA -> GTAGTGGAAAG
CGTTTAGTTTT -> GTTTAGTTTTC
CAGGCGTGTCT -> AGGCGTGTCTT
CCCAATTGACG -> CCAATTGACGA
TATACACGAAA -> ATACACGAAAA
CTTAACATCCG -> TTAACATCCGA
TGGATTGTGGC -> GGATTGTGGCA
AAGGTTCGAGT -> AGGTTCGAGTA
CTCCTAGTTGA -> TCCTAGTTGAC
TTAACAGCGTT -> TAACAGCGTTC
AACACATCGGC -> ACACATCGGCA
AGTTTTCAGGC -> GTTTTCAGGCC
CCGGATGTATA -> CGGATGTATAT
GAGGTGGCTAC -> AGGTGGCTACG
CTCCTGTTCGT -> TCCTGTTCGTT
TCAGTTTAACA -> CAGTTTAACAG
CGCCCGAAACG -> GCCCGAAACGT
GCGAATGTGAG -> CGAATGTGAGT
CCGGTTGTACT -> CGGTTGTACTT
TACTTGGGGTA -> ACTTGGGGTAT
TACGTACACTA -> ACGTACACTAC
CGCCTACTTGG -> GCCTACTTGGG
TAAATACGAAG -> AAATACGAAGT
AGTGCCGCGAT -> GTGCCGCGATC
CAATTGACGAG -> AATTGACGAGT
CCATGTTAACC -> CATGTTAACCG
ACCGGTTGTAC -> CCGGTTGTACT
ATTTCCCACCC -> TTTCCCACCCT
GGGCGCCTACT -> GGCGCCTACTT
GCTGAGGATTA -> CTGAGGATTAA
TGCAACCATAT -> GCAACCATATC
CATGTTGAAAT -> ATGTTGAAATC
CTCCTGTCAAG -> TCCTGTCAAGG
ACCGCGGACGC -> CCGCGGACGCC
CCCAGTGGCGC -> CCAGTGGCGCT
CCTACTTGGGG -> CTACTTGGGGT
TCAGGGTATGA -> CAGGGTATGAT
CCACCCAGGCG -> CACCCAGGCGT
TGTGCATCTAT -> GTGCATCTATG
ATCTATAATCT -> TCTATAATCTT
CATCTATGCCC -> ATCTATGCCCC
CAGCGCTCGAG -> AGCGCTCGAGT
TCAGGCCTGTC -> CAGGCCTGTCT
AGGCTCCTAGT -> GGCTCCTAGTT
CAATGGCATCG -> AATGGCATCGG
GGTTGTTAGCC -> GTTGTTAGCCC
AATGTGAGTCG -> ATGTGAGTCGC
GTTACAATATG -> TTACAATATGT
GTCTGCAGTCT -> TCTGCAGTCTT
TTGGCATTAGT -> TGGCATTAGTC
CTGTCACGCCG -> TGTCACGCCGA
GAAGACACTGG -> AAGACACTGGG
AAATCTTGGAG -> AATCTTGGAGG
GAGCACTGCCA -> AGCACTGCCAG
CCATGTTCTAG -> CATGTTCTAGT
GCGCTCGAGTG -> CGCTCGAGTGA
AGCCTCACACT -> GCCTCACACTA
GGGCCGAGCGC -> GGCCGAGCGCG
GTGTCCGGATC -> TGTCCGGATCG
CGAGTCTACTG -> GAGTCTACTGG
TGTTCTAGTGA -> GTTCTAGTGAT
